X/PROPN/nsubj>_castle/PROPN/nsubj>_be/VERB/ROOT_<Y/NOUN/attr	forward
X/PROPN/nsubj>_hotel/PROPN/nsubj>_be/VERB/ROOT_<Y/NOUN/attr	forward
X/NOUN/nsubj>_device/NOUN/nsubj>_be/VERB/ROOT_<Y/NOUN/attr	reverse
X/NOUN/conj_<specie/NOUN/conj_<Y/NOUN/compound	forward
X/NOUN/pobj_<be/VERB/relcl_<Y/PROPN/attr	reverse
X/NOUN/attr_<Y/NOUN/appos	reverse
X/PROPN/pobj_<Y/NOUN/appos	forward
the/DET/det<_X/PROPN/pobj_<Y/NOUN/appos	forward
X/NOUN/dobj_<Y/NOUN/conj	reverse
missile/NOUN/nmod<_X/NOUN/dobj_<Y/NOUN/conj	reverse
submarine/NOUN/compound<_X/NOUN/dobj_<Y/NOUN/conj	reverse
X/NOUN/dobj_<Y/NOUN/conj_>mount/NOUN/conj	reverse
X/NOUN/nsubj>_catfish/NOUN/nsubj>_be/VERB/ROOT_<Y/NOUN/attr	forward
X/NOUN/dobj_<of/ADP/prep_<Y/NOUN/pobj	reverse
the/DET/det<_X/NOUN/dobj_<of/ADP/prep_<Y/NOUN/pobj	reverse
X/NOUN/pobj_<as/ADP/prep_<Y/NOUN/pobj	reverse
large/ADJ/amod<_X/NOUN/pobj_<as/ADP/prep_<Y/NOUN/pobj	reverse
X/NOUN/nsubjpass_<of/ADP/prep_<Y/NOUN/pobj	reverse
the/DET/det<_X/NOUN/nsubjpass_<of/ADP/prep_<Y/NOUN/pobj	reverse
X/NOUN/nmod>_missile/NOUN/nmod>_stage/NOUN/ROOT_<Y/NOUN/compound	forward
X/NOUN/pobj_<Y/NOUN/appos	reverse
X/NOUN/appos_<Y/NOUN/conj	forward
X/NOUN/appos_<Y/NOUN/conj_>and/CCONJ/cc	forward
X/PROPN/nsubjpass_<Y/NOUN/appos	forward
X/PROPN/nsubjpass_<Y/NOUN/appos_>of/ADP/prep	forward
X/NOUN/nsubjpass_<as/ADP/prep_<Y/NOUN/pobj	reverse
X/NOUN/pobj_<range/VERB/acl_<from/ADP/prep_<Y/NOUN/pobj	reverse
X/NOUN/pobj_<use/VERB/relcl_<be/VERB/xcomp_<Y/NOUN/attr	reverse
X/PROPN/pobj_<be/VERB/relcl_<Y/NOUN/attr	forward
the/DET/det<_X/PROPN/pobj_<be/VERB/relcl_<Y/NOUN/attr	forward
X/NOUN/nsubj_<Y/NOUN/conj	forward
the/DET/det<_X/NOUN/nsubj_<Y/NOUN/conj	forward
X/NOUN/pobj_<of/ADP/prep_<Y/NOUN/pobj	reverse
X/NOUN/nsubj>_animal/NOUN/nsubj>_include/VERB/ROOT_<Y/NOUN/dobj	reverse
X/NOUN/nsubj>_food/NOUN/nsubj>_be/VERB/ROOT_<Y/NOUN/attr	reverse
X/NOUN/conj_<as/ADP/prep_<Y/NOUN/pobj	reverse
small/ADJ/amod<_X/NOUN/conj_<as/ADP/prep_<Y/NOUN/pobj	reverse
X/NOUN/nsubjpass>_fish/NOUN/nsubjpass>_call/VERB/ROOT_<Y/NOUN/oprd	reverse
X/NOUN/pobj_<in/ADP/prep_<street/PROPN/pobj_<Y/PROPN/compound	reverse
X/PROPN/nsubj>_house/PROPN/nsubj>_be/VERB/ROOT_<Y/NOUN/attr	reverse
X/NOUN/nsubj>_hotel/NOUN/nsubj>_have/VERB/ROOT_<Y/NOUN/dobj	forward
X/NOUN/compound>_grenade/NOUN/compound>_Y/NOUN/ROOT	forward
expensive/ADJ/amod<_X/NOUN/pobj_<Y/NOUN/appos	reverse
X/NOUN/pobj_<Y/NOUN/appos_>pear/NOUN/conj	reverse
some/DET/det<_X/NOUN/pobj_<as/ADP/prep_<Y/NOUN/pobj	reverse
X/NOUN/ROOT_<like/ADP/prep_<Y/NOUN/pobj	forward
X/NOUN/pobj_<of/ADP/prep_<Y/PROPN/pobj	forward
the/DET/det<_X/NOUN/pobj_<of/ADP/prep_<Y/PROPN/pobj	forward
X/NOUN/pobj_<of/ADP/prep_<Y/PROPN/pobj_>of/ADP/prep	forward
X/NOUN/conj_<launch/NOUN/conj_<Y/NOUN/compound	forward
commercial/ADJ/amod<_X/NOUN/conj_<launch/NOUN/conj_<Y/NOUN/compound	forward
X/PROPN/conj_<Y/PROPN/conj	forward
X/NOUN/dobj_<as/ADP/prep_<Y/NOUN/pobj	reverse
X/NOUN/nsubjpass>_building/NOUN/nsubjpass>_erect/VERB/ROOT_<Y/NOUN/npadvmod	reverse
X/NOUN/nsubj>_castle/NOUN/nsubj>_be/VERB/ROOT_<Y/NOUN/attr	forward
X/PROPN/nsubj_<Y/NOUN/appos	forward
the/DET/det<_X/PROPN/nsubj_<Y/NOUN/appos	forward
X/NOUN/nsubj>_axe/NOUN/nsubj>_be/VERB/ROOT_<Y/NOUN/attr	forward
X/NOUN/conj_<like/ADP/prep_<Y/NOUN/pobj	forward
X/NOUN/dobj_<as/ADP/prep_<Y/PROPN/pobj	reverse
alnwick/PROPN/compound<_X/PROPN/conj_<Y/PROPN/conj	forward
X/NOUN/nsubj>_weapon/NOUN/nsubj>_be/VERB/ROOT_<Y/NOUN/attr	reverse
X/NOUN/nsubj>_weapon/NOUN/nsubj>_Y/NOUN/ROOT	reverse
the/DET/det<_X/NOUN/nsubj>_weapon/NOUN/nsubj>_Y/NOUN/ROOT	reverse
particular/ADJ/amod<_X/NOUN/pobj_<as/ADP/prep_<Y/NOUN/pobj	reverse
X/NOUN/compound>_animal/NOUN/compound>_style/NOUN/ROOT_<Y/NOUN/appos	reverse
X/PROPN/nmod_<Y/PROPN/conj	forward
-pron-/ADJ/poss<_X/NOUN/pobj_<of/ADP/prep_<Y/PROPN/pobj	reverse
X/PROPN/nsubj>_cathedral/PROPN/nsubj>_be/VERB/ROOT_<Y/NOUN/attr	forward
X/NOUN/appos_<of/ADP/prep_<Y/PROPN/pobj	reverse
the/DET/det<_X/NOUN/appos_<of/ADP/prep_<Y/PROPN/pobj	reverse
the/DET/det<_X/NOUN/appos_<Y/NOUN/conj	reverse
ui/NOUN/amod<_X/NOUN/appos_<Y/NOUN/conj	reverse
sucker/NOUN/compound<_X/NOUN/appos_<Y/NOUN/conj	reverse
-pron-/ADJ/poss<_X/NOUN/pobj_<of/ADP/prep_<Y/NOUN/pobj	reverse
X/NOUN/appos_<with/ADP/prep_<Y/NOUN/pobj	forward
X/NOUN/nmod>_bus/NOUN/nmod>_manufacturer/NOUN/ROOT_<Y/NOUN/compound	forward
the/DET/det<_X/NOUN/dobj_<as/ADP/prep_<Y/NOUN/pobj	forward
X/NOUN/pobj_<Y/PROPN/appos	forward
the/DET/det<_X/NOUN/pobj_<Y/PROPN/appos	forward
X/NOUN/attr_<of/ADP/prep_<Y/NOUN/pobj	reverse
X/NOUN/attr_<classify/VERB/acl_<as/ADP/prep_<Y/NOUN/pobj	reverse
X/NOUN/dobj_<Y/NOUN/appos	forward
X/NOUN/dobj_<Y/NOUN/appos_>name/VERB/acl	forward
X/NOUN/conj_<Y/NOUN/conj	forward
X/NOUN/pobj_<Y/PROPN/conj	reverse
the/DET/det<_X/NOUN/pobj_<Y/PROPN/conj	reverse
X/NOUN/pobj_<Y/NOUN/conj	forward
X/NOUN/nsubj>_ship/NOUN/nsubj>_be/VERB/ROOT_<Y/NOUN/attr	reverse
record/VERB/compound<_X/NOUN/conj_<Y/NOUN/conj	reverse
X/NOUN/nsubj>_missile/NOUN/nsubj>_be/VERB/ROOT_<Y/NOUN/attr	forward
new/ADJ/amod<_X/NOUN/pobj_<Y/NOUN/appos	reverse
X/NOUN/compound>_missile/NOUN/compound>_missile/NOUN/ROOT_<Y/NOUN/appos	forward
the/DET/det<_X/NOUN/dobj_<Y/NOUN/appos	forward
standard/ADJ/amod<_X/NOUN/dobj_<Y/NOUN/appos	forward
missile/NOUN/compound<_X/NOUN/dobj_<Y/NOUN/appos	forward
surface/NOUN/nmod<_X/NOUN/dobj_<Y/NOUN/appos	forward
X/NOUN/attr_<Y/NOUN/conj	forward
16/NUM/nummod<_X/NOUN/attr_<Y/NOUN/conj	forward
like/ADJ/amod<_X/NOUN/attr_<Y/NOUN/conj	forward
X/NOUN/attr_<Y/NOUN/conj_>missile/NOUN/conj	forward
76/NUM/nummod<_X/NOUN/conj_<Y/NOUN/conj	reverse
unguided/ADJ/amod<_X/NOUN/conj_<Y/NOUN/conj	reverse
X/NOUN/conj_<Y/NOUN/conj_>and/CCONJ/cc	reverse
X/NOUN/conj_<Y/NOUN/conj_>cannon/NOUN/conj	reverse
X/NOUN/nsubj>_rifle/NOUN/nsubj>_be/VERB/ROOT_<Y/NOUN/attr	forward
X/NOUN/nsubj>_vehicle/NOUN/nsubj>_be/VERB/ROOT_<Y/NOUN/attr	reverse
X/NOUN/nsubjpass_<in/ADP/prep_<Y/NOUN/pobj	forward
X/PROPN/nsubj>_lizard/PROPN/nsubj>_be/VERB/ROOT_<Y/NOUN/attr	forward
X/PROPN/conj_<Y/PROPN/conj_>and/CCONJ/cc	reverse
the/DET/det<_X/NOUN/pobj_<of/ADP/prep_<Y/NOUN/pobj	reverse
original/ADJ/amod<_X/NOUN/pobj_<of/ADP/prep_<Y/NOUN/pobj	reverse
X/PROPN/compound>_cathedral/PROPN/compound>_Y/NOUN/ROOT	forward
X/NOUN/pobj_<by/ADP/prep_<commission/PROPN/pobj_<Y/PROPN/nmod	forward
X/PROPN/nsubj>_deer/PROPN/nsubj>_be/VERB/ROOT_<Y/NOUN/attr	forward
X/NOUN/dobj_<Y/NOUN/conj_>with/ADP/prep	reverse
fortify/VERB/amod<_X/NOUN/attr_<Y/NOUN/conj	reverse
X/NOUN/pobj_<at/ADP/prep_<Y/NOUN/pobj	reverse
-pron-/ADJ/poss<_X/NOUN/pobj_<at/ADP/prep_<Y/NOUN/pobj	reverse
X/NOUN/nsubj>_cathedral/NOUN/nsubj>_be/VERB/ROOT_<Y/NOUN/attr	forward
X/NOUN/pobj_<Y/NOUN/appos_>be/VERB/relcl	reverse
X/PROPN/pobj_<of/ADP/prep_<Y/PROPN/pobj	reverse
the/DET/det<_X/PROPN/pobj_<of/ADP/prep_<Y/PROPN/pobj	reverse
one/NUM/nummod<_X/NOUN/pobj_<Y/NOUN/conj	forward
roman/ADJ/amod<_X/NOUN/pobj_<Y/NOUN/conj	forward
X/NOUN/nsubj>_house/NOUN/nsubj>_be/VERB/ROOT_<Y/PROPN/attr	reverse
X/NOUN/nsubj>_grenade/NOUN/nsubj>_be/VERB/ROOT_<Y/NOUN/attr	forward
X/NOUN/conj_<on/ADP/prep_<Y/NOUN/pobj	forward
X/NOUN/pobj_<include/VERB/prep_<Y/NOUN/pobj	reverse
water/NOUN/compound<_X/NOUN/pobj_<include/VERB/prep_<Y/NOUN/pobj	reverse
X/NOUN/nmod>_frigate/NOUN/nmod>_Y/NOUN/ROOT	forward
X/PROPN/nsubj_<Y/NOUN/conj	forward
X/PROPN/nsubj_<Y/NOUN/conj_>in/ADP/prep	forward
the/DET/det<_X/NOUN/pobj_<Y/NOUN/conj	reverse
X/NOUN/pobj_<Y/NOUN/conj_>and/CCONJ/cc	reverse
X/NOUN/nsubj>_car/NOUN/nsubj>_be/VERB/ROOT_<Y/NOUN/attr	forward
X/NOUN/dobj_<of/ADP/prep_<Y/PROPN/pobj	reverse
the/DET/det<_X/NOUN/dobj_<of/ADP/prep_<Y/PROPN/pobj	reverse
X/NOUN/pobj_<moskva/PROPN/appos_<Y/PROPN/compound	reverse
X/PROPN/nsubj>_catfish/PROPN/nsubj>_be/VERB/ROOT_<Y/NOUN/attr	forward
X/NOUN/nsubj_<know/VERB/acl_<as/ADP/prep_<Y/PROPN/pobj	reverse
X/NOUN/nsubj>_building/NOUN/nsubj>_have/VERB/ROOT_<Y/NOUN/dobj	reverse
X/NOUN/pobj_<of/ADP/prep_<Y/PROPN/pobj_>in/ADP/prep	reverse
X/NOUN/nsubj>_building/NOUN/nsubj>_be/VERB/ROOT_<Y/NOUN/attr	reverse
X/NOUN/attr_<Y/NOUN/conj_>or/CCONJ/cc	reverse
other/ADJ/amod<_X/NOUN/pobj_<as/ADP/prep_<Y/NOUN/pobj	reverse
X/PROPN/pobj_<Y/NOUN/appos_>of/ADP/prep	forward
X/NOUN/nmod_<Y/NOUN/conj	reverse
X/NOUN/nsubj>_robe/NOUN/nsubj>_be/VERB/ROOT_<Y/NOUN/attr	forward
X/PROPN/dobj_<Y/PROPN/conj	forward
X/PROPN/pobj_<Y/PROPN/conj	reverse
X/PROPN/pobj_<Y/PROPN/conj_>have/VERB/relcl	reverse
X/PROPN/pobj_<Y/PROPN/conj_>and/CCONJ/cc	reverse
an/DET/det<_X/NOUN/dobj_<as/ADP/prep_<Y/NOUN/pobj	reverse
X/NOUN/dobj_<of/ADP/prep_<Y/PROPN/pobj_>of/ADP/prep	forward
life/NOUN/compound<_X/NOUN/pobj_<as/ADP/prep_<Y/NOUN/pobj	reverse
both/CCONJ/det<_X/NOUN/pobj_<Y/NOUN/conj	reverse
mobile/ADJ/amod<_X/NOUN/dobj_<Y/NOUN/conj	forward
X/NOUN/compound>_car/NOUN/compound>_Y/NOUN/ROOT	forward
X/NOUN/nsubj>_fish/NOUN/nsubj>_be/VERB/ROOT_<Y/NOUN/attr	reverse
X/NOUN/attr_<Y/NOUN/conj_>and/CCONJ/cc	reverse
some/DET/det<_X/NOUN/pobj_<Y/NOUN/conj	reverse
X/NOUN/nsubj>_fish/NOUN/nsubj>_include/VERB/ROOT_<Y/NOUN/dobj	reverse
birch/NOUN/compound<_X/NOUN/conj_<Y/NOUN/conj	reverse
X/NOUN/nsubj>_clothing/NOUN/nsubj>_include/VERB/ROOT_<Y/NOUN/dobj	reverse
X/NOUN/nsubj>_animal/NOUN/nsubj>_be/VERB/ROOT_<Y/NOUN/attr	reverse
X/PROPN/nsubj>_castle/PROPN/nsubj>_be/VERB/ROOT_<Y/PROPN/attr	forward
X/NOUN/compound>_boat/NOUN/compound>_Y/NOUN/ROOT	reverse
star/NOUN/compound<_X/NOUN/dobj_<Y/NOUN/appos	forward
X/NOUN/dobj_<Y/NOUN/appos_>and/CCONJ/cc	forward
X/NOUN/nsubjpass>_weapon/NOUN/nsubjpass>_Y/NOUN/ROOT	reverse
this/DET/det<_X/NOUN/nsubjpass>_weapon/NOUN/nsubjpass>_Y/NOUN/ROOT	reverse
bamboo/PROPN/compound<_X/NOUN/nsubjpass>_weapon/NOUN/nsubjpass>_Y/NOUN/ROOT	reverse
-pron-/ADJ/poss<_X/NOUN/pobj_<Y/NOUN/conj	forward
portable/ADJ/amod<_X/NOUN/pobj_<as/ADP/prep_<Y/NOUN/pobj	reverse
electronic/ADJ/amod<_X/NOUN/pobj_<as/ADP/prep_<Y/NOUN/pobj	reverse
cell/NOUN/compound<_X/NOUN/conj_<Y/NOUN/conj	forward
the/DET/det<_X/PROPN/pobj_<Y/PROPN/conj	forward
X/PROPN/pobj_<Y/PROPN/conj_>in/ADP/prep	forward
X/NOUN/nsubj>_frigate/NOUN/nsubj>_be/VERB/ROOT_<Y/NOUN/attr	forward
the/DET/det<_X/NOUN/conj_<Y/NOUN/conj	reverse
v-2/PROPN/punct<_X/NOUN/conj_<Y/NOUN/conj	reverse
X/NOUN/conj_<Y/NOUN/conj_>kill/VERB/relcl	reverse
mobile/ADJ/amod<_X/NOUN/conj_<Y/NOUN/conj	forward
X/NOUN/nsubj>_hotel/NOUN/nsubj>_provide/VERB/ROOT_<Y/NOUN/dobj	forward
X/PROPN/dobj_<Y/PROPN/conj_>in/ADP/prep	forward
X/PROPN/dobj_<Y/PROPN/conj_>and/CCONJ/cc	forward
X/PROPN/dobj_<Y/PROPN/conj_>house/PROPN/conj	forward
X/PROPN/dobj_<house/PROPN/conj_<Y/PROPN/conj	forward
X/NOUN/compound>_television/NOUN/compound>_Y/NOUN/ROOT	forward
X/NOUN/compound>_weapon/NOUN/compound>_system/NOUN/ROOT_<Y/PROPN/appos	reverse
X/NOUN/nsubj_<in/ADP/prep_<Y/NOUN/pobj	reverse
X/NOUN/nsubj>_bomb/NOUN/nsubj>_be/VERB/ROOT_<Y/NOUN/attr	forward
X/NOUN/nsubj>_hotel/NOUN/nsubj>_become/VERB/ROOT_<Y/NOUN/attr	forward
X/NOUN/pobj_<next/ADV/advmod_<to/ADP/prep_<Y/NOUN/pobj	reverse
the/DET/det<_X/NOUN/attr_<of/ADP/prep_<Y/NOUN/pobj	reverse
lead/ADJ/amod<_X/NOUN/attr_<of/ADP/prep_<Y/NOUN/pobj	reverse
X/NOUN/attr_<of/ADP/prep_<Y/NOUN/pobj_>of/ADP/prep	reverse
X/NOUN/conj_<meat/NOUN/conj_<Y/NOUN/compound	forward
star/NOUN/compound<_X/NOUN/conj_<Y/NOUN/conj	forward
X/NOUN/dobj_<include/VERB/prep_<Y/NOUN/pobj	reverse
several/ADJ/amod<_X/NOUN/dobj_<include/VERB/prep_<Y/NOUN/pobj	reverse
large/ADJ/amod<_X/NOUN/dobj_<include/VERB/prep_<Y/NOUN/pobj	reverse
anthropomorphic/ADJ/amod<_X/NOUN/dobj_<include/VERB/prep_<Y/NOUN/pobj	reverse
X/NOUN/dobj_<include/VERB/prep_<Y/NOUN/pobj_>in/ADP/prep	reverse
X/NOUN/nmod_<propulsion/NOUN/conj_<Y/NOUN/compound	reverse
armoured/ADJ/amod<_X/NOUN/conj_<Y/NOUN/conj	reverse
command/NOUN/compound<_X/NOUN/conj_<Y/NOUN/conj	reverse
X/NOUN/ROOT_<be/VERB/conj_<Y/NOUN/attr	forward
X/NOUN/conj_<Y/NOUN/appos	reverse
X/PROPN/pobj_<house/PROPN/conj_<Y/PROPN/conj	reverse
montagu/PROPN/compound<_X/PROPN/conj_<Y/PROPN/conj	reverse
X/NOUN/attr_<famous/ADJ/amod_<as/ADP/prep_<Y/NOUN/pobj	forward
X/NOUN/nsubj>_hotel/NOUN/nsubj>_be/VERB/ROOT_<Y/NOUN/attr	forward
other/ADJ/amod<_X/NOUN/pobj_<include/VERB/prep_<Y/NOUN/pobj	reverse
X/NOUN/pobj_<similar/ADJ/amod_<to/ADP/prep_<Y/NOUN/pobj	reverse
some/DET/det<_X/NOUN/conj_<Y/NOUN/conj	forward
main/ADJ/amod<_X/NOUN/conj_<Y/NOUN/conj	reverse
X/PROPN/pobj_<castle/PROPN/conj_<Y/PROPN/conj	forward
windsor/PROPN/compound<_X/PROPN/pobj_<castle/PROPN/conj_<Y/PROPN/conj	forward
X/PROPN/conj_<Y/PROPN/conj_>abbey/PROPN/conj	forward
tower/NOUN/compound<_X/NOUN/pobj_<of/ADP/prep_<Y/NOUN/pobj	reverse
X/NOUN/pobj_<Y/NOUN/conj_>or/CCONJ/cc	reverse
X/NOUN/pobj_<Y/NOUN/conj_>aircraft/NOUN/conj	reverse
X/NOUN/nsubjpass_<Y/NOUN/appos	forward
the/DET/det<_X/NOUN/nsubjpass_<Y/NOUN/appos	forward
X/NOUN/nsubj>_pig/NOUN/nsubj>_be/VERB/ROOT_<Y/NOUN/attr	forward
X/NOUN/dobj_<of/ADP/prep_<Y/PROPN/pobj_>in/ADP/prep	reverse
X/NOUN/nsubj>_tree/NOUN/nsubj>_be/VERB/ROOT_<Y/NOUN/attr	reverse
X/PROPN/nsubj_<Y/PROPN/conj	reverse
native/ADJ/amod<_X/NOUN/pobj_<Y/NOUN/conj	forward
X/PROPN/pobj_<Y/PROPN/conj_>of/ADP/prep	forward
X/PROPN/compound>_poplar/PROPN/compound>_road/PROPN/ROOT_<Y/PROPN/compound	forward
X/PROPN/conj_<vehicle/NOUN/conj_<Y/NOUN/appos	reverse
one/NUM/nummod<_X/PROPN/conj_<vehicle/NOUN/conj_<Y/NOUN/appos	reverse
bls/PROPN/compound<_X/PROPN/conj_<vehicle/NOUN/conj_<Y/NOUN/appos	reverse
first/PROPN/compound<_X/PROPN/conj_<vehicle/NOUN/conj_<Y/NOUN/appos	reverse
response/PROPN/compound<_X/PROPN/conj_<vehicle/NOUN/conj_<Y/NOUN/appos	reverse
two/NUM/nummod<_X/NOUN/conj_<Y/NOUN/appos	reverse
chief/ADJ/amod<_X/NOUN/conj_<Y/NOUN/appos	reverse
X/NOUN/conj_<Y/NOUN/appos_>and/CCONJ/cc	reverse
X/PROPN/nsubj_<be/VERB/relcl_<Y/NOUN/attr	forward
X/PROPN/attr_<Y/NOUN/appos	forward
X/PROPN/compound>_pine/PROPN/compound>_inn/ADV/ROOT_<Y/PROPN/compound	forward
X/NOUN/compound>_hotel/NOUN/compound>_Y/NOUN/ROOT	forward
park/PROPN/compound<_X/PROPN/pobj_<Y/PROPN/conj	forward
the/DET/det<_X/PROPN/conj_<Y/PROPN/conj	forward
X/NOUN/compound>_ferry/NOUN/compound>_Y/NOUN/ROOT	forward
X/NOUN/nsubj>_tool/NOUN/nsubj>_be/VERB/ROOT_<Y/NOUN/attr	reverse
X/NOUN/nsubj>_chisel/NOUN/nsubj>_be/VERB/ROOT_<Y/NOUN/attr	forward
X/PROPN/pobj_<Y/NOUN/conj	forward
the/DET/det<_X/PROPN/pobj_<Y/NOUN/conj	forward
X/PROPN/attr_<Y/NOUN/conj	forward
X/NOUN/conj_<Y/PROPN/appos	reverse
the/DET/det<_X/NOUN/conj_<Y/PROPN/appos	reverse
alto/PROPN/compound<_X/NOUN/conj_<Y/PROPN/appos	reverse
X/NOUN/conj_<building/PROPN/conj_<hall/PROPN/conj_<Y/PROPN/conj	reverse
X/PROPN/conj_<hall/PROPN/conj_<Y/PROPN/conj	reverse
gable/PROPN/poss<_X/PROPN/conj_<hall/PROPN/conj_<Y/PROPN/conj	reverse
X/NOUN/nsubj>_building/NOUN/nsubj>_include/VERB/ROOT_<Y/NOUN/dobj	reverse
the/DET/det<_X/PROPN/nsubjpass_<Y/NOUN/appos	forward
X/PROPN/nsubjpass_<Y/NOUN/appos_>in/ADP/prep	forward
X/NOUN/pobj_<for/ADP/prep_<Y/NOUN/pobj	reverse
X/NOUN/pobj_<as/ADP/prep_<Y/NOUN/pobj_>bass/NOUN/conj	reverse
X/NOUN/compound>_fish/NOUN/compound>_dish/NOUN/ROOT_<Y/NOUN/appos	reverse
the/DET/det<_X/NOUN/dobj_<Y/NOUN/conj	reverse
plane/NOUN/compound<_X/NOUN/dobj_<Y/NOUN/conj	reverse
X/NOUN/dobj_<Y/NOUN/conj_>willow/ADJ/conj	reverse
small/ADJ/amod<_X/NOUN/nsubjpass_<as/ADP/prep_<Y/NOUN/pobj	reverse
durham/PROPN/compound<_X/PROPN/pobj_<Y/NOUN/appos	forward
X/PROPN/pobj_<Y/NOUN/appos_>survive/VERB/relcl	forward
X/NOUN/pobj_<Y/NOUN/appos_>and/CCONJ/cc	reverse
X/NOUN/pobj_<use/VERB/relcl_<as/ADP/prep_<Y/NOUN/pobj	reverse
X/NOUN/amod>_pine/NOUN/amod>_Y/NOUN/ROOT	forward
X/PROPN/dobj_<be/VERB/relcl_<Y/NOUN/attr	forward
the/DET/det<_X/PROPN/dobj_<be/VERB/relcl_<Y/NOUN/attr	forward
X/NOUN/nsubj_<of/ADP/prep_<Y/NOUN/pobj	reverse
the/DET/det<_X/NOUN/nsubj_<of/ADP/prep_<Y/NOUN/pobj	reverse
X/PROPN/nsubj>_hospital/PROPN/nsubj>_be/VERB/ROOT_<Y/NOUN/attr	forward
X/NOUN/nsubj>_root/NOUN/nsubj>_include/VERB/ROOT_<Y/NOUN/dobj	reverse
X/NOUN/pobj_<next/ADV/advmod_<to/ADP/prep_<Y/PROPN/pobj	reverse
X/NOUN/pobj_<call/VERB/acl_<Y/NOUN/oprd	reverse
X/NOUN/pobj_<as/ADP/prep_<Y/PROPN/pobj	reverse
X/NOUN/conj_<of/ADP/prep_<Y/NOUN/pobj	reverse
the/DET/det<_X/NOUN/conj_<of/ADP/prep_<Y/NOUN/pobj	reverse
X/NOUN/dobj_<Y/PROPN/conj	reverse
the/DET/det<_X/NOUN/dobj_<Y/PROPN/conj	reverse
many/ADJ/amod<_X/NOUN/pobj_<include/VERB/prep_<Y/NOUN/pobj	reverse
X/NOUN/conj_<as/ADP/prep_<Y/NOUN/pobj_>and/CCONJ/cc	reverse
X/NOUN/nsubj_<of/ADP/prep_<Y/NOUN/pobj_>in/ADP/prep	reverse
X/NOUN/nsubj>_carp/NOUN/nsubj>_be/VERB/ROOT_<Y/NOUN/attr	forward
X/NOUN/conj_<Y/NOUN/amod	reverse
X/PROPN/conj_<Y/NOUN/appos	reverse
an/DET/det<_X/PROPN/conj_<Y/NOUN/appos	reverse
X/NOUN/nsubj_<Y/NOUN/appos	reverse
all/DET/det<_X/NOUN/pobj_<as/ADP/prep_<Y/NOUN/pobj	reverse
X/NOUN/pobj_<as/ADP/prep_<Y/NOUN/pobj_>and/CCONJ/cc	reverse
X/NOUN/pobj_<as/ADP/prep_<Y/NOUN/pobj_>salmon/NOUN/conj	reverse
recoilless/NOUN/compound<_X/NOUN/conj_<Y/NOUN/conj	forward
X/NOUN/pobj_<specie/NOUN/appos_<of/ADP/prep_<Y/NOUN/pobj	reverse
old/ADJ/amod<_X/NOUN/dobj_<Y/PROPN/conj	reverse
X/NOUN/pobj_<within/ADP/prep_<Y/NOUN/pobj	reverse
bath/NOUN/compound<_X/NOUN/pobj_<within/ADP/prep_<Y/NOUN/pobj	reverse
X/PROPN/nsubj>_birch/PROPN/nsubj>_be/VERB/ROOT_<Y/NOUN/attr	forward
X/NOUN/nsubj>_firearm/NOUN/nsubj>_be/VERB/ROOT_<Y/NOUN/attr	reverse
an/DET/det<_X/NOUN/pobj_<Y/NOUN/conj	forward
X/PROPN/nsubj>_carp/PROPN/nsubj>_be/VERB/ROOT_<Y/NOUN/attr	forward
X/NOUN/nmod>_missile/NOUN/nmod>_technology/NOUN/ROOT_<Y/NOUN/compound	forward
X/NOUN/dobj_<Y/PROPN/appos	reverse
X/NOUN/nsubj>_gun/NOUN/nsubj>_be/VERB/ROOT_<Y/NOUN/attr	forward
X/PROPN/conj_<Y/NOUN/conj	forward
the/DET/det<_X/PROPN/conj_<Y/NOUN/conj	forward
X/PROPN/conj_<house/PROPN/conj_<Y/PROPN/conj	reverse
X/PROPN/conj_<house/PROPN/conj_<Y/PROPN/conj_>and/CCONJ/cc	reverse
X/PROPN/conj_<house/PROPN/conj_<Y/PROPN/conj_>abbey/PROPN/conj	reverse
X/PROPN/ROOT_<Y/NOUN/appos	reverse
X/PROPN/ROOT_<Y/NOUN/appos_>in/ADP/prep	reverse
fresh/ADJ/amod<_X/NOUN/pobj_<as/ADP/prep_<Y/NOUN/pobj	reverse
orthodox/PROPN/compound<_X/PROPN/conj_<Y/PROPN/conj	forward
X/PROPN/conj_<Y/PROPN/conj_>cathedral/PROPN/conj	forward
futurist/NOUN/compound<_X/PROPN/conj_<Y/PROPN/conj	reverse
tagliero/PROPN/compound<_X/PROPN/conj_<Y/PROPN/conj	reverse
X/PROPN/conj_<Y/PROPN/conj_>palace/PROPN/conj	reverse
X/NOUN/nsubj_<as/ADP/prep_<Y/NOUN/pobj	reverse
farm/NOUN/compound<_X/NOUN/pobj_<as/ADP/prep_<Y/NOUN/pobj	reverse
sugar/NOUN/compound<_X/NOUN/conj_<Y/NOUN/conj	forward
X/NOUN/conj_<Y/NOUN/conj_>output/NOUN/dobj	forward
large/ADJ/amod<_X/NOUN/pobj_<Y/NOUN/conj	forward
X/NOUN/nsubj>_building/NOUN/nsubj>_be/VERB/ROOT_<Y/PROPN/attr	reverse
the/DET/det<_X/NOUN/pobj_<as/ADP/prep_<Y/NOUN/pobj	reverse
X/NOUN/nsubj>_weapon/NOUN/nsubj>_be/VERB/ROOT_<Y/PROPN/attr	reverse
X/NOUN/nsubj>_moth/NOUN/nsubj>_be/VERB/ROOT_<Y/NOUN/attr	forward
windsor/PROPN/compound<_X/PROPN/conj_<Y/PROPN/conj	forward
X/PROPN/conj_<Y/PROPN/conj_>castle/PROPN/conj	forward
sandringham/PROPN/compound<_X/PROPN/conj_<Y/PROPN/conj	reverse
X/NOUN/nsubj>_building/NOUN/nsubj>_become/VERB/ROOT_<Y/PROPN/attr	reverse
X/NOUN/pobj_<as/ADP/prep_<Y/NOUN/pobj_>truck/NOUN/conj	reverse
stollmeyer/PROPN/poss<_X/PROPN/conj_<Y/NOUN/appos	forward
X/PROPN/conj_<Y/NOUN/appos_>model/VERB/acl	forward
X/NOUN/appos_<model/VERB/acl_<on/ADP/prep_<Y/PROPN/pobj	reverse
X/NOUN/attr_<related/ADJ/amod_<to/ADP/prep_<Y/NOUN/pobj	reverse
X/NOUN/nsubjpass_<include/VERB/prep_<Y/NOUN/pobj	reverse
the/DET/det<_X/NOUN/pobj_<Y/NOUN/appos	reverse
first/ADJ/amod<_X/NOUN/pobj_<Y/NOUN/appos	reverse
X/NOUN/compound>_animal/NOUN/compound>_Y/NOUN/ROOT	reverse
-pron-/ADJ/poss<_X/NOUN/conj_<Y/PROPN/appos	reverse
X/NOUN/pobj_<Y/NOUN/conj_>in/ADP/prep	forward
X/NOUN/compound>_food/NOUN/compound>_crop/NOUN/ROOT_<Y/NOUN/appos	reverse
X/NOUN/attr_<of/ADP/prep_<olav/PROPN/pobj_<Y/NOUN/appos	forward
X/NOUN/dobj_<system/NOUN/appos_<Y/NOUN/compound	reverse
only/ADJ/amod<_X/NOUN/dobj_<system/NOUN/appos_<Y/NOUN/compound	reverse
nuclear/ADJ/amod<_X/NOUN/dobj_<system/NOUN/appos_<Y/NOUN/compound	reverse
different/ADJ/amod<_X/NOUN/pobj_<include/VERB/prep_<Y/NOUN/pobj	reverse
X/PROPN/nsubj>_hotel/PROPN/nsubj>_provide/VERB/ROOT_<Y/NOUN/dobj	forward
X/NOUN/pobj_<call/VERB/acl_<Y/PROPN/oprd	reverse
an/DET/det<_X/NOUN/pobj_<call/VERB/acl_<Y/PROPN/oprd	reverse
antique/ADJ/amod<_X/NOUN/pobj_<call/VERB/acl_<Y/PROPN/oprd	reverse
X/NOUN/attr_<as/ADP/prep_<Y/NOUN/pobj	reverse
X/NOUN/pobj_<Y/NOUN/appos_>with/ADP/prep	forward
X/NOUN/dobj_<call/VERB/acl_<Y/NOUN/oprd	forward
the/DET/det<_X/NOUN/attr_<Y/NOUN/conj	forward
large/ADJ/amod<_X/NOUN/nsubjpass_<as/ADP/prep_<Y/NOUN/pobj	reverse
X/NOUN/nsubjpass_<as/ADP/prep_<Y/NOUN/pobj_>and/CCONJ/cc	reverse
X/NOUN/compound>_missile/NOUN/compound>_Y/NOUN/ROOT	forward
X/PROPN/pobj_<Y/NOUN/conj_>of/ADP/prep	reverse
X/NOUN/nsubjpass_<of/ADP/prep_<Y/PROPN/pobj	reverse
the/DET/det<_X/NOUN/nsubjpass_<of/ADP/prep_<Y/PROPN/pobj	reverse
fatty/NOUN/amod<_X/NOUN/pobj_<as/ADP/prep_<Y/NOUN/pobj	reverse
assault/NOUN/compound<_X/NOUN/pobj_<Y/NOUN/appos	forward
hand/NOUN/compound<_X/NOUN/conj_<Y/NOUN/conj	forward
X/NOUN/attr_<use/VERB/relcl_<as/ADP/prep_<Y/NOUN/pobj	forward
X/NOUN/nsubj>_building/NOUN/nsubj>_include/VERB/ROOT_<Y/PROPN/dobj	reverse
X/PROPN/pobj_<in/ADP/prep_<Y/PROPN/pobj	reverse
the/DET/det<_X/PROPN/pobj_<in/ADP/prep_<Y/PROPN/pobj	reverse
old/ADJ/amod<_X/NOUN/dobj_<Y/NOUN/appos	reverse
dwell/VERB/amod<_X/NOUN/pobj_<as/ADP/prep_<Y/NOUN/pobj	reverse
freshwater/NOUN/amod<_X/NOUN/pobj_<as/ADP/prep_<Y/NOUN/pobj	reverse
many/ADJ/amod<_X/NOUN/dobj_<Y/NOUN/appos	reverse
X/NOUN/attr_<one/NUM/appos_<of/ADP/prep_<Y/NOUN/pobj	reverse
an/DET/det<_X/NOUN/dobj_<Y/NOUN/appos	reverse
X/NOUN/dobj_<Y/NOUN/appos_>or/CCONJ/cc	reverse
X/NOUN/attr_<be/VERB/relcl_<Y/NOUN/attr	reverse
X/NOUN/appos_<of/ADP/prep_<Y/NOUN/pobj	reverse
the/DET/det<_X/NOUN/appos_<of/ADP/prep_<Y/NOUN/pobj	reverse
first/ADJ/amod<_X/NOUN/dobj_<Y/NOUN/appos	reverse
X/NOUN/dobj_<Y/NOUN/appos_>for/ADP/prep	reverse
the/DET/det<_X/NOUN/nsubj_<Y/NOUN/appos	reverse
alnwick/PROPN/compound<_X/PROPN/pobj_<Y/PROPN/conj	forward
X/PROPN/pobj_<Y/PROPN/conj_>house/PROPN/conj	forward
alnwick/PROPN/compound<_X/PROPN/pobj_<house/PROPN/conj_<Y/PROPN/conj	forward
X/PROPN/pobj_<house/PROPN/conj_<Y/PROPN/conj_>and/CCONJ/cc	forward
X/PROPN/pobj_<house/PROPN/conj_<Y/PROPN/conj_>house/PROPN/conj	forward
X/PROPN/pobj_<house/PROPN/conj_<house/PROPN/conj_<Y/PROPN/conj	forward
X/PROPN/nsubj>_pine/PROPN/nsubj>_be/VERB/ROOT_<Y/NOUN/attr	forward
other/ADJ/amod<_X/NOUN/pobj_<Y/NOUN/conj	reverse
the/DET/det<_X/NOUN/pobj_<call/VERB/acl_<Y/PROPN/oprd	reverse
X/NOUN/nsubj>_deer/NOUN/nsubj>_be/VERB/ROOT_<Y/NOUN/attr	forward
paul/PROPN/poss<_X/PROPN/pobj_<Y/NOUN/conj	forward
X/PROPN/pobj_<Y/NOUN/conj_>in/ADP/prep	forward
X/NOUN/pobj_<intermediate/ADJ/amod_<between/ADP/prep_<Y/NOUN/pobj	reverse
X/NOUN/dobj_<be/VERB/relcl_<Y/NOUN/attr	reverse
X/NOUN/nsubj>_train/NOUN/nsubj>_be/VERB/ROOT_<Y/NOUN/attr	forward
X/NOUN/pobj_<include/VERB/prep_<Y/NOUN/pobj_>and/CCONJ/cc	reverse
X/NOUN/attr_<use/VERB/acl_<as/ADP/prep_<Y/NOUN/pobj	reverse
X/NOUN/compound>_corn/NOUN/compound>_Y/NOUN/ROOT	forward
X/NOUN/attr_<relate/VERB/acl_<to/ADP/prep_<Y/NOUN/pobj	reverse
X/PROPN/dobj_<Y/PROPN/conj_>building/PROPN/conj	forward
X/PROPN/dobj_<building/PROPN/conj_<Y/PROPN/conj	forward
the/DET/det<_X/PROPN/dobj_<Y/PROPN/conj	forward
ferguson/PROPN/compound<_X/NOUN/dobj_<Y/NOUN/appos	forward
X/NOUN/nsubj>_lion/NOUN/nsubj>_be/VERB/ROOT_<Y/NOUN/attr	forward
eight/NUM/nummod<_X/NOUN/pobj_<Y/NOUN/appos	reverse
other/ADJ/amod<_X/NOUN/pobj_<Y/NOUN/appos	reverse
X/NOUN/conj_<fire/NOUN/conj_<Y/NOUN/compound	forward
X/NOUN/nsubjpass_<know/VERB/acl_<as/ADP/prep_<Y/PROPN/pobj	forward
freshwater/NOUN/amod<_X/NOUN/pobj_<include/VERB/prep_<Y/NOUN/pobj	reverse
game/NOUN/compound<_X/NOUN/pobj_<include/VERB/prep_<Y/NOUN/pobj	reverse
military/ADJ/amod<_X/NOUN/pobj_<include/VERB/prep_<Y/NOUN/pobj	reverse
X/NOUN/nsubj_<include/VERB/prep_<Y/NOUN/pobj	reverse
other/ADJ/amod<_X/NOUN/nsubj_<include/VERB/prep_<Y/NOUN/pobj	reverse
X/NOUN/nsubj_<include/VERB/prep_<Y/NOUN/pobj_>and/CCONJ/cc	reverse
X/NOUN/attr_<Y/NOUN/appos_>of/ADP/prep	forward
X/PROPN/nsubj_<Y/NOUN/appos_>in/ADP/prep	forward
tropical/ADJ/amod<_X/NOUN/pobj_<as/ADP/prep_<Y/NOUN/pobj	reverse
X/NOUN/conj_<zapote/NOUN/conj_<Y/NOUN/conj_>and/CCONJ/cc	forward
X/NOUN/conj_<zapote/NOUN/conj_<Y/NOUN/conj_>banana/NOUN/conj	forward
such/ADJ/amod<_X/NOUN/conj_<as/ADP/prep_<Y/NOUN/pobj	reverse
any/DET/det<_X/NOUN/dobj_<as/ADP/prep_<Y/NOUN/pobj	reverse
X/PROPN/dobj_<palace/PROPN/conj_<Y/PROPN/conj	reverse
the/DET/det<_X/PROPN/dobj_<palace/PROPN/conj_<Y/PROPN/conj	reverse
X/NOUN/pobj_<fuel/NOUN/conj_<Y/NOUN/compound	forward
the/DET/det<_X/NOUN/pobj_<fuel/NOUN/conj_<Y/NOUN/compound	forward
X/NOUN/conj_<Y/NOUN/conj_>create/VERB/acl	forward
X/NOUN/compound>_vehicle/NOUN/compound>_service/NOUN/ROOT_<Y/NOUN/compound	reverse
style/NOUN/compound<_X/NOUN/pobj_<Y/NOUN/conj	forward
X/NOUN/pobj_<system/NOUN/conj_<Y/NOUN/compound	forward
machine/NOUN/compound<_X/NOUN/pobj_<system/NOUN/conj_<Y/NOUN/compound	forward
X/NOUN/nsubj>_building/NOUN/nsubj>_become/VERB/ROOT_<Y/NOUN/attr	reverse
X/NOUN/conj_<launcher/NOUN/conj_<Y/NOUN/compound	forward
surface/NOUN/nmod<_X/NOUN/conj_<launcher/NOUN/conj_<Y/NOUN/compound	forward
X/NOUN/dobj_<in/ADP/prep_<Y/PROPN/pobj	reverse
X/NOUN/dobj_<in/ADP/prep_<Y/NOUN/pobj	reverse
an/DET/det<_X/NOUN/dobj_<in/ADP/prep_<Y/NOUN/pobj	reverse
X/PROPN/conj_<Y/NOUN/conj_>and/CCONJ/cc	forward
food/NOUN/compound<_X/NOUN/pobj_<as/ADP/prep_<Y/NOUN/pobj	reverse
X/NOUN/pobj_<as/ADP/prep_<Y/NOUN/pobj_>duck/NOUN/conj	reverse
X/NOUN/dobj_<like/ADP/prep_<Y/NOUN/pobj	reverse
X/NOUN/compound>_fruit/NOUN/compound>_Y/NOUN/ROOT	reverse
other/ADJ/amod<_X/NOUN/nsubjpass_<as/ADP/prep_<Y/NOUN/pobj	reverse
X/NOUN/attr_<for/ADP/prep_<company/NOUN/pobj_<Y/NOUN/compound	reverse
X/NOUN/appos_<find/VERB/acl_<to/ADP/prep_<Y/PROPN/pobj	reverse
X/NOUN/nsubj>_salmon/NOUN/nsubj>_be/VERB/ROOT_<Y/NOUN/attr	forward
X/NOUN/conj_<for/ADP/prep_<Y/NOUN/pobj	reverse
X/NOUN/appos_<Y/NOUN/appos	forward
the/DET/det<_X/NOUN/appos_<Y/NOUN/appos	forward
X/PROPN/pobj_<near/ADP/prep_<Y/PROPN/pobj	reverse
X/NOUN/appos_<relate/VERB/acl_<to/ADP/prep_<Y/NOUN/pobj	reverse
X/NOUN/compound>_vehicle/NOUN/compound>_route/NOUN/ROOT_<Y/NOUN/compound	reverse
X/PROPN/nsubj_<Y/NOUN/appos_>and/CCONJ/cc	forward
X/NOUN/nsubj>_garment/NOUN/nsubj>_be/VERB/ROOT_<Y/NOUN/attr	reverse
X/NOUN/pobj_<building/NOUN/conj_<Y/NOUN/compound	reverse
X/NOUN/nsubj>_rabbit/NOUN/nsubj>_be/VERB/ROOT_<Y/NOUN/attr	forward
portable/ADJ/amod<_X/NOUN/pobj_<Y/NOUN/conj	forward
an/DET/det<_X/NOUN/pobj_<Y/NOUN/appos	reverse
anthropomorphic/ADJ/amod<_X/NOUN/pobj_<Y/NOUN/appos	reverse
circuit/NOUN/compound<_X/NOUN/conj_<Y/NOUN/conj	forward
small/ADJ/amod<_X/NOUN/pobj_<Y/NOUN/appos	reverse
X/NOUN/nmod>_bus/NOUN/nmod>_Y/NOUN/ROOT	forward
X/NOUN/pobj_<than/ADP/prep_<Y/NOUN/pobj	reverse
main/ADJ/amod<_X/NOUN/nsubjpass_<of/ADP/prep_<Y/PROPN/pobj	reverse
X/NOUN/nsubj>_bear/NOUN/nsubj>_be/VERB/ROOT_<Y/NOUN/attr	forward
X/NOUN/nsubj_<carry/VERB/acl_<by/ADP/agent_<Y/NOUN/pobj	reverse
X/NOUN/appos_<as/ADP/prep_<Y/NOUN/pobj	forward
machine/NOUN/compound<_X/NOUN/appos_<as/ADP/prep_<Y/NOUN/pobj	forward
X/PROPN/compound>_castle/PROPN/compound>_Y/NOUN/ROOT	forward
X/NOUN/dobj_<include/VERB/prep_<tim/PROPN/pobj_<Y/NOUN/appos	forward
many/ADJ/amod<_X/NOUN/dobj_<include/VERB/prep_<Y/NOUN/pobj	forward
X/NOUN/nsubj>_eagle/NOUN/nsubj>_be/VERB/ROOT_<Y/NOUN/attr	forward
X/NOUN/nsubj>_weapon/NOUN/nsubj>_include/VERB/ROOT_<Y/NOUN/dobj	reverse
X/NOUN/appos_<of/ADP/prep_<family/NOUN/pobj_<Y/NOUN/compound	reverse
X/NOUN/pobj_<equip/VERB/acl_<with/ADP/prep_<Y/NOUN/pobj	forward
X/NOUN/ROOT_<defence/PROPN/appos_<Y/PROPN/compound	reverse
advance/NOUN/nmod<_X/NOUN/ROOT_<defence/PROPN/appos_<Y/PROPN/compound	reverse
re/ADP/nmod<_X/NOUN/ROOT_<defence/PROPN/appos_<Y/PROPN/compound	reverse
X/PROPN/compound>_castle/PROPN/compound>_hill/PROPN/ROOT_<Y/PROPN/conj	forward
an/DET/det<_X/NOUN/pobj_<Y/PROPN/appos	reverse
X/NOUN/pobj_<Y/PROPN/appos_>in/ADP/prep	reverse
X/PROPN/compound>_ferry/PROPN/compound>_inn/PROPN/ROOT_<Y/PROPN/compound	forward
X/NOUN/pobj_<serve/VERB/relcl_<as/ADP/prep_<Y/NOUN/pobj	forward
X/NOUN/nsubj>_vessel/NOUN/nsubj>_employ/VERB/ROOT_<Y/NOUN/dobj	reverse
X/PROPN/nsubj>_willow/PROPN/nsubj>_be/VERB/ROOT_<Y/NOUN/attr	forward
command/NOUN/nmod<_X/NOUN/conj_<Y/NOUN/conj	reverse
X/NOUN/dobj_<from/ADP/prep_<program/NOUN/pobj_<Y/NOUN/compound	reverse
X/PROPN/pobj_<Y/NOUN/appos_>on/ADP/prep	forward
X/NOUN/pobj_<know/VERB/acl_<as/ADP/prep_<Y/NOUN/pobj	reverse
X/NOUN/ROOT_<as/ADP/prep_<Y/NOUN/pobj	reverse
medieval/ADJ/amod<_X/NOUN/pobj_<Y/NOUN/conj	forward
X/NOUN/compound>_grenade/NOUN/compound>_launcher/NOUN/ROOT_<Y/NOUN/appos	forward
private/ADJ/amod<_X/NOUN/pobj_<Y/NOUN/conj	reverse
X/NOUN/nsubj>_tree/NOUN/nsubj>_include/VERB/ROOT_<Y/NOUN/dobj	reverse
fortify/VERB/amod<_X/NOUN/dobj_<Y/NOUN/conj	reverse
manor/NOUN/compound<_X/NOUN/dobj_<Y/NOUN/conj	reverse
manor/NOUN/compound<_X/NOUN/dobj_<Y/PROPN/appos	reverse
X/PROPN/pobj_<Y/NOUN/appos_>in/ADP/prep	forward
X/NOUN/pobj_<use/VERB/acl_<as/ADP/prep_<Y/NOUN/pobj	forward
-pron-/ADJ/poss<_X/NOUN/dobj_<Y/NOUN/appos	reverse
X/NOUN/pobj_<be/VERB/relcl_<Y/NOUN/attr	forward
various/ADJ/amod<_X/NOUN/pobj_<include/VERB/prep_<Y/NOUN/pobj	reverse
X/PROPN/nsubj>_car/PROPN/nsubj>_be/VERB/ROOT_<Y/NOUN/attr	forward
X/NOUN/dobj_<turn/VERB/relcl_<be/VERB/xcomp_<Y/NOUN/attr	reverse
X/NOUN/nsubj>_animal/NOUN/nsubj>_Y/NOUN/ROOT	reverse
the/DET/det<_X/NOUN/nsubj>_animal/NOUN/nsubj>_Y/NOUN/ROOT	reverse
X/NOUN/dobj_<combine/VERB/relcl_<into/ADP/prep_<Y/NOUN/pobj	forward
X/NOUN/pobj_<like/ADP/prep_<Y/NOUN/pobj	reverse
X/NOUN/nsubjpass>_fish/NOUN/nsubjpass>_Y/NOUN/ROOT	reverse
X/NOUN/dobj_<of/ADP/prep_<cactus/NOUN/pobj_<Y/NOUN/compound	reverse
X/NOUN/pobj_<in/ADP/prep_<family/NOUN/pobj_<Y/NOUN/compound	reverse
mobile/ADJ/amod<_X/NOUN/pobj_<Y/NOUN/conj	forward
X/PROPN/nsubj>_bear/PROPN/nsubj>_be/VERB/ROOT_<Y/NOUN/attr	forward
white/PROPN/compound<_X/PROPN/pobj_<Y/NOUN/conj	forward
X/NOUN/compound>_fish/NOUN/compound>_specie/NOUN/ROOT_<Y/NOUN/appos	reverse
X/NOUN/conj_<type/NOUN/conj_<of/ADP/prep_<Y/NOUN/pobj	forward
X/NOUN/pobj_<of/ADP/prep_<Y/NOUN/pobj_>to/ADP/prep	reverse
X/NOUN/nsubj_<house/VERB/relcl_<Y/NOUN/dobj	reverse
the/DET/det<_X/NOUN/nsubj_<house/VERB/relcl_<Y/NOUN/dobj	reverse
construction/NOUN/compound<_X/NOUN/conj_<as/ADP/prep_<Y/NOUN/pobj	reverse
X/NOUN/compound>_food/NOUN/compound>_grain/NOUN/ROOT_<Y/NOUN/appos	reverse
X/NOUN/dobj_<for/ADP/prep_<Y/NOUN/pobj	forward
X/NOUN/nsubjpass_<Y/PROPN/appos	reverse
mm/NOUN/compound<_X/NOUN/conj_<Y/NOUN/conj	forward
X/PROPN/conj_<Y/PROPN/conj_>theatre/PROPN/conj	reverse
X/PROPN/compound>_pine/PROPN/compound>_hole/PROPN/ROOT_<Y/PROPN/compound	forward
X/NOUN/ROOT_<be/VERB/conj_<Y/NOUN/attr_>design/VERB/acl	forward
X/NOUN/compound>_arm/NOUN/compound>_Y/NOUN/ROOT	reverse
X/NOUN/dobj_<include/VERB/relcl_<Y/NOUN/dobj	reverse
X/NOUN/pobj_<during/ADP/prep_<season/PROPN/pobj_<Y/PROPN/compound	reverse
X/PROPN/conj_<Y/PROPN/conj_>hotel/PROPN/conj	forward
X/NOUN/ROOT_<Y/NOUN/appos	reverse
X/PROPN/nsubj>_rifle/PROPN/nsubj>_be/VERB/ROOT_<Y/NOUN/attr	forward
X/NOUN/conj_<tree/NOUN/conj_<Y/NOUN/compound	forward
X/NOUN/nsubj>_car/NOUN/nsubj>_hit/VERB/ROOT_<Y/NOUN/dobj	forward
X/NOUN/attr_<in/ADP/prep_<Y/NOUN/pobj	forward
X/PROPN/pobj_<Y/NOUN/appos_>serve/VERB/relcl	forward
island/NOUN/poss<_X/NOUN/pobj_<Y/NOUN/conj	reverse
main/ADJ/amod<_X/NOUN/pobj_<Y/NOUN/conj	reverse
X/NOUN/attr_<Y/NOUN/relcl	forward
X/PROPN/conj_<Y/PROPN/conj_>manor/PROPN/conj	reverse
cable/NOUN/compound<_X/NOUN/pobj_<Y/NOUN/conj	forward
X/NOUN/appos_<include/VERB/prep_<Y/NOUN/pobj	reverse
X/NOUN/pobj_<Y/NOUN/conj_>as/ADP/prep	forward
other/ADJ/amod<_X/NOUN/conj_<as/ADP/prep_<Y/NOUN/pobj	reverse
X/PROPN/pobj_<Y/NOUN/appos_>and/CCONJ/cc	forward
X/PROPN/compound>_pine/PROPN/compound>_state/PROPN/ROOT_<Y/PROPN/compound	forward
many/ADJ/amod<_X/NOUN/dobj_<as/ADP/prep_<Y/NOUN/pobj	reverse
other/ADJ/amod<_X/NOUN/dobj_<as/ADP/prep_<Y/NOUN/pobj	reverse
X/NOUN/dobj_<as/ADP/prep_<Y/NOUN/pobj_>or/CCONJ/cc	reverse
-pron-/ADJ/poss<_X/NOUN/pobj_<Y/NOUN/appos	reverse
X/PROPN/dobj_<Y/NOUN/appos	forward
X/PROPN/pobj_<Y/NOUN/appos_>able/ADJ/amod	forward
white/ADJ/amod<_X/NOUN/appos_<Y/NOUN/conj	reverse
lake/NOUN/compound<_X/NOUN/conj_<Y/NOUN/conj	forward
rainbow/NOUN/compound<_X/NOUN/conj_<Y/NOUN/conj	forward
french/ADJ/amod<_X/NOUN/nsubj_<Y/NOUN/conj	forward
X/NOUN/nsubj_<Y/NOUN/conj_>and/CCONJ/cc	forward
combination/NOUN/compound<_X/NOUN/attr_<Y/NOUN/conj	forward
X/NOUN/compound>_gun/NOUN/compound>_Y/NOUN/ROOT	forward
X/NOUN/pobj_<consist/VERB/acl_<of/ADP/prep_<Y/NOUN/pobj	reverse
X/PROPN/compound>_ferry/PROPN/compound>_Y/PROPN/ROOT	forward
X/NOUN/compound>_vehicle/NOUN/compound>_park/NOUN/ROOT_<Y/NOUN/compound	reverse
X/NOUN/pobj_<aircraft/NOUN/conj_<Y/NOUN/conj_>or/CCONJ/cc	reverse
X/NOUN/pobj_<aircraft/NOUN/conj_<Y/NOUN/conj_>bullet/NOUN/conj	reverse
X/NOUN/nsubj>_television/NOUN/nsubj>_be/VERB/ROOT_<Y/NOUN/attr	forward
X/NOUN/nsubj>_dolphin/NOUN/nsubj>_be/VERB/ROOT_<Y/NOUN/attr	forward
X/NOUN/attr_<to/ADP/prep_<Y/NOUN/pobj	reverse
X/NOUN/dobj_<system/PROPN/conj_<Y/PROPN/compound	reverse
either/CCONJ/preconj<_X/NOUN/dobj_<system/PROPN/conj_<Y/PROPN/compound	reverse
mm/NOUN/nmod<_X/NOUN/dobj_<system/PROPN/conj_<Y/PROPN/compound	reverse
unguided/ADJ/amod<_X/NOUN/dobj_<system/PROPN/conj_<Y/PROPN/compound	reverse
X/PROPN/compound>_pine/PROPN/compound>_society/PROPN/ROOT_<Y/PROPN/compound	forward
X/NOUN/pobj_<adjacent/ADJ/amod_<to/ADP/prep_<Y/PROPN/pobj	reverse
game/NOUN/compound<_X/NOUN/pobj_<as/ADP/prep_<Y/NOUN/pobj	reverse
X/PROPN/nsubjpass_<Y/PROPN/appos	forward
the/DET/det<_X/PROPN/nsubjpass_<Y/PROPN/appos	forward
X/NOUN/attr_<launch/VERB/relcl_<Y/NOUN/dobj	reverse
X/PROPN/dobj_<punch/PROPN/conj_<Y/PROPN/compound	forward
X/NOUN/compound>_animal/NOUN/compound>_vector/NOUN/ROOT_<Y/NOUN/parataxis	reverse
X/NOUN/pobj_<know/VERB/acl_<as/ADP/prep_<Y/PROPN/pobj	reverse
X/NOUN/nsubj_<Y/PROPN/conj	reverse
the/DET/det<_X/NOUN/nsubj_<Y/PROPN/conj	reverse
anadromous/ADJ/amod<_X/NOUN/pobj_<as/ADP/prep_<Y/NOUN/pobj	reverse
X/NOUN/nsubj>_hospital/NOUN/nsubj>_have/VERB/ROOT_<Y/NOUN/dobj	forward
large/ADJ/amod<_X/NOUN/dobj_<be/VERB/relcl_<Y/NOUN/attr	reverse
X/NOUN/compound>_rocket/NOUN/compound>_Y/NOUN/ROOT	reverse
anadromous/ADJ/amod<_X/NOUN/dobj_<as/ADP/prep_<Y/NOUN/pobj	reverse
X/NOUN/acomp_<Y/NOUN/conj	forward
small/ADJ/amod<_X/NOUN/dobj_<as/ADP/prep_<Y/NOUN/pobj	reverse
X/NOUN/attr_<similar/ADJ/amod_<to/ADP/prep_<Y/NOUN/pobj	reverse
X/NOUN/oprd_<Y/NOUN/conj	forward
X/NOUN/nsubjpass_<be/VERB/relcl_<Y/PROPN/attr	reverse
the/DET/det<_X/NOUN/nsubjpass_<be/VERB/relcl_<Y/PROPN/attr	reverse
X/NOUN/attr_<resemble/VERB/acl_<Y/NOUN/dobj	reverse
X/NOUN/nsubj>_trout/NOUN/nsubj>_be/VERB/ROOT_<Y/NOUN/attr	forward
X/NOUN/pobj_<Y/NOUN/appos_>of/ADP/prep	forward
X/NOUN/conj_<of/ADP/prep_<Y/PROPN/pobj	reverse
the/DET/det<_X/NOUN/conj_<of/ADP/prep_<Y/PROPN/pobj	reverse
X/NOUN/nmod>_gun/NOUN/nmod>_Y/NOUN/ROOT	forward
X/NOUN/appos_<replace/VERB/relcl_<Y/NOUN/dobj	reverse
four/NUM/nummod<_X/NOUN/dobj_<Y/NOUN/appos	reverse
X/NOUN/pobj_<as/ADP/prep_<Y/NOUN/pobj_>elk/NOUN/conj	reverse
police/NOUN/compound<_X/NOUN/conj_<Y/NOUN/conj	forward
X/NOUN/nsubjpass>_building/NOUN/nsubjpass>_name/VERB/ROOT_<Y/PROPN/oprd	reverse
coniferous/ADJ/amod<_X/NOUN/pobj_<as/ADP/prep_<Y/NOUN/pobj	reverse
X/NOUN/attr_<in/ADP/prep_<Y/PROPN/pobj	reverse
X/NOUN/attr_<in/ADP/prep_<Y/PROPN/pobj_>of/ADP/prep	reverse
green/ADJ/amod<_X/NOUN/dobj_<Y/NOUN/conj	forward
X/NOUN/ROOT_<Y/NOUN/parataxis	reverse
strictly/ADV/advmod<_X/NOUN/ROOT_<Y/NOUN/parataxis	reverse
freshwater/NOUN/amod<_X/NOUN/ROOT_<Y/NOUN/parataxis	reverse
X/PROPN/oprd_<Y/NOUN/conj	forward
the/DET/det<_X/PROPN/oprd_<Y/NOUN/conj	forward
mobile/ADJ/amod<_X/NOUN/pobj_<as/ADP/prep_<Y/NOUN/pobj	reverse
X/NOUN/pobj_<as/ADP/prep_<Y/NOUN/pobj_>or/CCONJ/cc	reverse
X/NOUN/pobj_<as/ADP/prep_<Y/NOUN/pobj_>pda/NOUN/conj	reverse
integrated/PROPN/nmod<_X/PROPN/nmod_<Y/PROPN/conj	forward
X/NOUN/conj_<Y/NOUN/conj_>of/ADP/prep	forward
X/NOUN/nsubj>_cat/NOUN/nsubj>_be/VERB/ROOT_<Y/NOUN/attr	forward
X/NOUN/compound>_building/NOUN/compound>_Y/NOUN/ROOT	reverse
X/NOUN/dobj_<consist/VERB/acl_<of/ADP/prep_<Y/NOUN/pobj	reverse
fozzie/PROPN/compound<_X/PROPN/conj_<Y/PROPN/conj	forward
goatskin/NOUN/compound<_X/NOUN/dobj_<be/VERB/relcl_<Y/NOUN/attr	forward
X/PROPN/nsubjpass_<Y/PROPN/conj	forward
balmoral/PROPN/compound<_X/PROPN/nsubjpass_<Y/PROPN/conj	forward
X/NOUN/nsubjpass_<on/ADP/prep_<street/PROPN/pobj_<Y/PROPN/compound	reverse
X/NOUN/nsubj>_food/NOUN/nsubj>_Y/NOUN/ROOT	reverse
X/NOUN/nsubjpass_<with/ADP/prep_<Y/NOUN/pobj	reverse
X/NOUN/nsubj>_ambulance/NOUN/nsubj>_be/VERB/ROOT_<Y/NOUN/attr	forward
X/PROPN/nsubjpass_<Y/NOUN/conj	forward
X/PROPN/nsubj>_eagle/PROPN/nsubj>_be/VERB/ROOT_<Y/NOUN/attr	forward
X/NOUN/nsubj>_car/NOUN/nsubj>_strike/VERB/ROOT_<Y/NOUN/dobj	forward
X/NOUN/nsubj>_produce/NOUN/nsubj>_include/VERB/ROOT_<Y/NOUN/dobj	reverse
X/PROPN/compound>_castle/PROPN/compound>_organ/PROPN/ROOT_<Y/PROPN/compound	forward
X/PROPN/pobj_<elephant/PROPN/conj_<Y/PROPN/conj	reverse
X/PROPN/pobj_<Y/NOUN/appos_>with/ADP/prep	forward
X/PROPN/npadvmod_<Y/NOUN/conj	forward
two/NUM/nummod<_X/NOUN/pobj_<Y/NOUN/appos	reverse
X/NOUN/pobj_<artillery/NOUN/conj_<Y/NOUN/compound	forward
the/DET/det<_X/NOUN/pobj_<artillery/NOUN/conj_<Y/NOUN/compound	forward
javelin/PROPN/nmod<_X/NOUN/pobj_<artillery/NOUN/conj_<Y/NOUN/compound	forward
tank/NOUN/compound<_X/NOUN/pobj_<artillery/NOUN/conj_<Y/NOUN/compound	forward
X/NOUN/dobj_<shotgun/NOUN/appos_<Y/NOUN/appos	reverse
other/ADJ/amod<_X/NOUN/dobj_<shotgun/NOUN/appos_<Y/NOUN/appos	reverse
the/DET/det<_X/PROPN/dobj_<Y/NOUN/appos	forward
aircraft/NOUN/compound<_X/NOUN/nsubj_<Y/NOUN/appos	reverse
X/PROPN/compound>_weapon/PROPN/compound>_system/PROPN/ROOT_<Y/NOUN/appos	reverse
X/NOUN/dobj_<near/ADP/prep_<Y/NOUN/pobj	forward
black/ADJ/amod<_X/NOUN/pobj_<Y/NOUN/conj	forward
leather/NOUN/compound<_X/NOUN/pobj_<Y/NOUN/conj	forward
X/NOUN/nsubj_<of/ADP/prep_<Y/PROPN/pobj	reverse
the/DET/det<_X/NOUN/nsubj_<of/ADP/prep_<Y/PROPN/pobj	reverse
the/DET/det<_X/NOUN/dobj_<be/VERB/relcl_<Y/NOUN/attr	forward
X/PROPN/compound>_pine/PROPN/compound>_chief/PROPN/ROOT_<Y/PROPN/compound	forward
X/NOUN/nsubj>_fish/NOUN/nsubj>_be/VERB/ROOT_<Y/NOUN/acomp	reverse
X/NOUN/nsubj>_artifact/NOUN/nsubj>_be/VERB/ROOT_<Y/NOUN/attr	reverse
X/NOUN/appos_<weapon/NOUN/conj_<Y/NOUN/compound	reverse
lock/NOUN/amod<_X/NOUN/appos_<weapon/NOUN/conj_<Y/NOUN/compound	reverse
laser/NOUN/compound<_X/NOUN/appos_<weapon/NOUN/conj_<Y/NOUN/compound	reverse
X/NOUN/pobj_<of/ADP/prep_<Y/NOUN/pobj_>at/ADP/prep	reverse
X/PROPN/dobj_<Y/NOUN/conj	forward
the/DET/det<_X/PROPN/dobj_<Y/NOUN/conj	forward
X/PROPN/dobj_<Y/NOUN/conj_>in/ADP/prep	forward
X/NOUN/pobj_<kind/NOUN/conj_<of/ADP/prep_<Y/NOUN/pobj	forward
X/PROPN/pobj_<Y/NOUN/appos_>overlook/VERB/acl	forward
X/NOUN/conj_<receiver/NOUN/conj_<Y/NOUN/compound	reverse
X/NOUN/nsubj_<include/VERB/prep_<a/DET/pobj_<Y/NOUN/intj	reverse
X/NOUN/compound>_bomb/NOUN/compound>_Y/NOUN/ROOT	forward
one/NUM/nummod<_X/NOUN/conj_<Y/NOUN/conj	forward
many/ADJ/amod<_X/NOUN/pobj_<as/ADP/prep_<Y/NOUN/pobj	reverse
move/VERB/amod<_X/NOUN/pobj_<as/ADP/prep_<Y/NOUN/pobj	reverse
an/DET/det<_X/NOUN/pobj_<as/ADP/prep_<Y/NOUN/pobj	reverse
X/NOUN/dobj_<of/ADP/prep_<Y/NOUN/pobj_>at/ADP/prep	reverse
anadromous/ADJ/amod<_X/NOUN/pobj_<include/VERB/prep_<Y/NOUN/pobj	reverse
X/NOUN/pobj_<include/VERB/prep_<Y/NOUN/pobj_>salmon/NOUN/conj	reverse
alpine/NOUN/compound<_X/NOUN/pobj_<as/ADP/prep_<Y/NOUN/pobj	reverse
X/NOUN/nsubjpass_<Y/NOUN/conj	reverse
machine/NOUN/compound<_X/NOUN/dobj_<Y/NOUN/appos	forward
X/NOUN/dobj_<Y/NOUN/appos_>call/VERB/acl	forward
current/ADJ/amod<_X/NOUN/pobj_<of/ADP/prep_<Y/PROPN/pobj	reverse
X/NOUN/nsubj>_car/NOUN/nsubj>_force/VERB/ROOT_<Y/NOUN/dobj	forward
an/DET/det<_X/NOUN/dobj_<Y/NOUN/conj	forward
anadromous/ADJ/amod<_X/NOUN/nsubj_<as/ADP/prep_<Y/NOUN/pobj	reverse
X/NOUN/pobj_<Y/NOUN/appos_>or/CCONJ/cc	reverse
X/NOUN/conj_<Y/PROPN/conj	reverse
the/DET/det<_X/NOUN/conj_<Y/PROPN/conj	reverse
X/NOUN/conj_<Y/PROPN/conj_>and/CCONJ/cc	reverse
X/NOUN/compound>_phone/NOUN/compound>_Y/NOUN/ROOT	forward
X/NOUN/attr_<like/ADP/prep_<Y/NOUN/pobj	reverse
X/NOUN/compound>_weapon/NOUN/compound>_Y/NOUN/ROOT	reverse
the/DET/det<_X/NOUN/pobj_<system/NOUN/conj_<Y/NOUN/compound	forward
passion/NOUN/compound<_X/NOUN/conj_<Y/NOUN/conj	reverse
X/PROPN/conj_<Y/PROPN/conj_>museum/PROPN/conj	forward
X/NOUN/nsubj>_house/NOUN/nsubj>_be/VERB/ROOT_<Y/NOUN/attr	reverse
X/NOUN/pobj_<to/ADP/prep_<Y/NOUN/pobj	reverse
an/DET/det<_X/NOUN/pobj_<to/ADP/prep_<Y/NOUN/pobj	reverse
first/ADJ/amod<_X/NOUN/appos_<Y/NOUN/conj	forward
X/NOUN/appos_<Y/NOUN/conj_>in/ADP/prep	forward
X/PROPN/attr_<Y/PROPN/conj	reverse
X/PROPN/attr_<Y/PROPN/conj_>and/CCONJ/cc	reverse
X/PROPN/conj_<Y/PROPN/conj_>in/ADP/prep	forward
strategic/ADJ/amod<_X/NOUN/nmod_<Y/NOUN/conj	forward
airport/NOUN/compound<_X/NOUN/pobj_<Y/NOUN/conj	forward
X/NOUN/conj_<fruit/NOUN/conj_<Y/NOUN/compound	reverse
X/NOUN/compound>_pear/NOUN/compound>_Y/NOUN/ROOT	forward
X/NOUN/pobj_<like/ADP/prep_<Y/NOUN/pobj_>and/CCONJ/cc	reverse
large/ADJ/amod<_X/NOUN/pobj_<as/ADP/prep_<Y/PROPN/pobj	reverse
X/NOUN/compound>_vehicle/NOUN/compound>_Y/NOUN/ROOT	reverse
the/DET/det<_X/NOUN/conj_<Y/NOUN/appos	reverse
automatic/ADJ/amod<_X/NOUN/pobj_<Y/NOUN/conj	reverse
X/NOUN/pobj_<Y/NOUN/appos_>building/NOUN/conj	forward
X/PROPN/appos_<Y/NOUN/appos	forward
the/DET/det<_X/PROPN/appos_<Y/NOUN/appos	forward
X/PROPN/appos_<Y/NOUN/appos_>of/ADP/prep	forward
X/NOUN/compound>_stereo/NOUN/compound>_Y/NOUN/ROOT	forward
various/ADJ/amod<_X/NOUN/pobj_<as/ADP/prep_<Y/NOUN/pobj	reverse
pelagic/ADJ/amod<_X/NOUN/pobj_<as/ADP/prep_<Y/NOUN/pobj	reverse
X/NOUN/attr_<as/ADP/prep_<Y/NOUN/pobj_>or/CCONJ/cc	reverse
sandringham/PROPN/compound<_X/PROPN/pobj_<Y/PROPN/conj	reverse
passenger/NOUN/compound<_X/NOUN/pobj_<Y/NOUN/conj	forward
X/NOUN/dobj_<know/VERB/acl_<as/ADP/prep_<Y/PROPN/pobj	reverse
X/PROPN/compound>_pine/PROPN/compound>_point/PROPN/ROOT_<Y/PROPN/compound	forward
the/DET/det<_X/NOUN/pobj_<as/ADP/prep_<Y/PROPN/pobj	reverse
black/ADJ/amod<_X/NOUN/conj_<Y/NOUN/conj	forward
dry/VERB/amod<_X/NOUN/conj_<Y/NOUN/conj	reverse
X/NOUN/dobj_<at/ADP/prep_<Y/NOUN/pobj	reverse
X/NOUN/nsubj_<use/VERB/acl_<Y/NOUN/dobj	reverse
new/ADJ/amod<_X/NOUN/nsubj_<Y/NOUN/appos	reverse
X/NOUN/appos_<as/ADP/prep_<Y/NOUN/pobj_>and/CCONJ/cc	reverse
X/PROPN/appos_<Y/PROPN/conj	forward
the/DET/det<_X/PROPN/appos_<Y/PROPN/conj	forward
X/NOUN/nsubjpass>_weapon/NOUN/nsubjpass>_use/VERB/ROOT_<Y/NOUN/nsubjpass	reverse
X/NOUN/nsubjpass_<like/ADP/prep_<Y/NOUN/pobj	reverse
other/ADJ/amod<_X/NOUN/nsubjpass_<like/ADP/prep_<Y/NOUN/pobj	reverse
wild/ADJ/amod<_X/NOUN/pobj_<include/VERB/prep_<Y/NOUN/pobj	reverse
X/NOUN/pobj_<resemble/VERB/acl_<Y/NOUN/dobj	reverse
endanger/VERB/amod<_X/NOUN/dobj_<Y/NOUN/appos	reverse
powerful/ADJ/amod<_X/NOUN/dobj_<Y/NOUN/appos	reverse
X/NOUN/nmod>_hotel/NOUN/nmod>_ville/X/ROOT_<Y/NOUN/appos	forward
X/NOUN/nsubj>_corn/NOUN/nsubj>_be/VERB/ROOT_<Y/NOUN/attr	forward
cell/NOUN/compound<_X/NOUN/dobj_<Y/NOUN/conj	forward
X/PROPN/appos_<Y/NOUN/conj	forward
the/DET/det<_X/PROPN/appos_<Y/NOUN/conj	forward
X/PROPN/conj_<Y/PROPN/appos	reverse
the/DET/det<_X/PROPN/conj_<Y/PROPN/appos	reverse
X/NOUN/nsubj>_gun/NOUN/nsubj>_remain/VERB/ROOT_<Y/NOUN/attr	forward
X/NOUN/dobj_<of/ADP/prep_<Y/NOUN/pobj_>of/ADP/prep	reverse
X/NOUN/pobj_<service/NOUN/conj_<Y/NOUN/compound	forward
frequent/ADJ/amod<_X/NOUN/pobj_<service/NOUN/conj_<Y/NOUN/compound	forward
X/NOUN/nsubj>_vest/NOUN/nsubj>_be/VERB/ROOT_<Y/NOUN/attr	forward
X/NOUN/pobj_<guidance/NOUN/conj_<Y/NOUN/compound	reverse
X/NOUN/nsubj>_apple/NOUN/nsubj>_be/VERB/ROOT_<Y/NOUN/attr	forward
X/NOUN/nsubj>_shirt/NOUN/nsubj>_be/VERB/ROOT_<Y/NOUN/attr	forward
fly/VERB/amod<_X/NOUN/conj_<Y/NOUN/conj	reverse
X/NOUN/conj_<Y/NOUN/conj_>etc/X/conj	reverse
X/NOUN/attr_<available/ADJ/amod_<as/ADP/prep_<Y/NOUN/pobj	reverse
-pron-/ADJ/poss<_X/NOUN/nsubjpass_<Y/NOUN/appos	reverse
the/DET/det<_X/NOUN/pobj_<include/VERB/prep_<Y/NOUN/pobj	reverse
X/NOUN/appos_<be/VERB/relcl_<Y/NOUN/attr	forward
X/NOUN/appos_<be/VERB/relcl_<Y/NOUN/attr_>in/ADP/prep	forward
traditional/ADJ/amod<_X/NOUN/dobj_<include/VERB/prep_<Y/NOUN/pobj	reverse
chinese/ADJ/amod<_X/NOUN/dobj_<include/VERB/prep_<Y/NOUN/pobj	reverse
imperial/ADJ/amod<_X/NOUN/dobj_<include/VERB/prep_<Y/NOUN/pobj	reverse
X/NOUN/dobj_<include/VERB/prep_<Y/NOUN/pobj_>with/ADP/prep	reverse
X/NOUN/nsubj>_fork/NOUN/nsubj>_be/VERB/ROOT_<Y/NOUN/attr	forward
the/DET/det<_X/NOUN/attr_<Y/NOUN/appos	reverse
X/PROPN/attr_<Y/PROPN/conj_>of/ADP/prep	forward
X/NOUN/nsubjpass>_house/NOUN/nsubjpass>_call/VERB/ROOT_<Y/PROPN/oprd	reverse
X/NOUN/attr_<of/ADP/prep_<Y/PROPN/pobj	reverse
the/DET/det<_X/NOUN/attr_<of/ADP/prep_<Y/PROPN/pobj	reverse
X/NOUN/compound>_pine/NOUN/compound>_forest/NOUN/ROOT_<Y/NOUN/compound	forward
X/PROPN/pobj_<Y/PROPN/appos	reverse
the/DET/det<_X/PROPN/pobj_<Y/PROPN/appos	reverse
X/NOUN/dobj_<look/VERB/relcl_<like/ADP/prep_<Y/NOUN/pobj	reverse
wild/ADJ/amod<_X/NOUN/pobj_<Y/NOUN/appos	reverse
X/NOUN/appos_<like/ADP/prep_<Y/NOUN/pobj	reverse
an/DET/det<_X/NOUN/attr_<Y/NOUN/conj	reverse
two/NUM/nummod<_X/NOUN/pobj_<Y/PROPN/appos	reverse
X/NOUN/pobj_<Y/PROPN/appos_>find/VERB/relcl	reverse
X/NOUN/pobj_<in/ADP/prep_<series/NOUN/pobj_<Y/NOUN/compound	reverse
X/NOUN/nmod>_animal/NOUN/nmod>_play/VERB/nmod>_Y/NOUN/ROOT	reverse
X/PROPN/nmod>_frigate/PROPN/nmod>_Y/NOUN/ROOT	forward
X/NOUN/pobj_<Y/NOUN/appos_>inhabit/VERB/relcl	forward
army/NOUN/compound<_X/NOUN/pobj_<Y/NOUN/conj	reverse
any/DET/det<_X/NOUN/pobj_<Y/NOUN/appos	forward
capable/ADJ/amod<_X/NOUN/pobj_<Y/NOUN/appos	forward
X/NOUN/pobj_<near/ADP/prep_<Y/NOUN/pobj	reverse
X/NOUN/pobj_<supplement/VERB/acl_<by/ADP/agent_<Y/NOUN/pobj	reverse
X/NOUN/pobj_<grenade/PROPN/appos_<Y/PROPN/compound	forward
either/CCONJ/preconj<_X/NOUN/pobj_<grenade/PROPN/appos_<Y/PROPN/compound	forward
X/NOUN/nmod>_animal/NOUN/nmod>_Y/NOUN/ROOT	reverse
X/NOUN/attr_<be/VERB/relcl_<Y/NOUN/attr_>in/ADP/prep	forward
X/NOUN/pobj_<call/VERB/relcl_<Y/PROPN/oprd	reverse
X/PROPN/nsubj>_fish/PROPN/nsubj>_include/VERB/ROOT_<Y/NOUN/dobj	reverse
an/DET/det<_X/NOUN/attr_<Y/NOUN/appos	forward
duke/PROPN/nmod<_X/NOUN/attr_<Y/NOUN/appos	forward
class/NOUN/compound<_X/NOUN/attr_<Y/NOUN/appos	forward
X/NOUN/attr_<Y/NOUN/appos_>and/CCONJ/cc	forward
X/NOUN/attr_<Y/NOUN/appos_>ship/NOUN/conj	forward
X/NOUN/pobj_<use/VERB/acl_<track/NOUN/dobj_<Y/NOUN/nmod	forward
X/NOUN/attr_<include/VERB/prep_<Y/NOUN/pobj	reverse
the/DET/det<_X/NOUN/attr_<include/VERB/prep_<Y/NOUN/pobj	reverse
X/NOUN/compound>_food/NOUN/compound>_Y/NOUN/ROOT	reverse
conductive/ADJ/amod<_X/NOUN/attr_<Y/NOUN/appos	reverse
energy/NOUN/compound<_X/NOUN/attr_<Y/NOUN/appos	reverse
X/NOUN/attr_<Y/NOUN/appos_>know/VERB/acl	reverse
X/NOUN/ROOT_<Y/NOUN/conj	forward
X/NOUN/pobj_<behind/ADP/prep_<Y/PROPN/pobj	reverse
X/NOUN/nsubjpass>_building/NOUN/nsubjpass>_rename/VERB/ROOT_<Y/PROPN/oprd	reverse
X/NOUN/dobj_<Y/NOUN/conj_>and/CCONJ/cc	forward
other/ADJ/amod<_X/NOUN/pobj_<as/ADP/prep_<Y/PROPN/pobj	reverse
X/NOUN/pobj_<derive/VERB/acl_<from/ADP/prep_<Y/NOUN/pobj	reverse
sometimes/ADV/advmod<_X/NOUN/conj_<as/ADP/prep_<Y/NOUN/pobj	reverse
X/NOUN/nsubj>_poplar/NOUN/nsubj>_be/VERB/ROOT_<Y/NOUN/attr	forward
X/NOUN/nsubjpass_<Y/NOUN/appos_>of/ADP/prep	forward
old/ADJ/amod<_X/NOUN/dobj_<Y/NOUN/conj	forward
X/NOUN/nsubj>_villa/NOUN/nsubj>_be/VERB/ROOT_<Y/NOUN/attr	forward
X/PROPN/conj_<palace/PROPN/conj_<Y/PROPN/conj	forward
X/NOUN/nsubj_<Y/PROPN/appos	reverse
major/ADJ/amod<_X/NOUN/pobj_<as/ADP/prep_<Y/NOUN/pobj	reverse
X/NOUN/pobj_<as/ADP/prep_<Y/NOUN/pobj_>monkfish/NOUN/conj	reverse
X/NOUN/nsubj>_castle/NOUN/nsubj>_comprise/VERB/ROOT_<Y/NOUN/dobj	forward
any/DET/det<_X/NOUN/pobj_<as/ADP/prep_<Y/NOUN/pobj	reverse
X/PROPN/compound>_pine/PROPN/compound>_records/PROPN/ROOT_<Y/PROPN/compound	forward
X/NOUN/conj_<know/VERB/acl_<as/ADP/prep_<Y/NOUN/pobj	reverse
small/ADJ/amod<_X/NOUN/dobj_<Y/NOUN/conj	forward
like/ADJ/amod<_X/NOUN/dobj_<Y/NOUN/conj	reverse
X/NOUN/compound>_hospital/NOUN/compound>_Y/NOUN/ROOT	forward
X/NOUN/nsubj_<at/ADP/prep_<Y/NOUN/pobj	reverse
X/PROPN/dobj_<Y/NOUN/appos_>of/ADP/prep	forward
X/NOUN/attr_<with/ADP/prep_<motor/NOUN/pobj_<Y/NOUN/compound	forward
X/NOUN/pobj_<adjacent/ADJ/amod_<to/ADP/prep_<Y/NOUN/pobj	reverse
X/NOUN/amod>_pine/NOUN/amod>_forest/NOUN/ROOT_<Y/NOUN/compound	forward
X/NOUN/ROOT_<consume/VERB/acl_<Y/NOUN/dobj	reverse
land/NOUN/compound<_X/NOUN/ROOT_<consume/VERB/acl_<Y/NOUN/dobj	reverse
X/NOUN/nsubj>_clothe/NOUN/nsubj>_be/VERB/ROOT_<Y/NOUN/attr	reverse
X/PROPN/ROOT_<Y/PROPN/appos	forward
four/NUM/nummod<_X/NOUN/pobj_<Y/NOUN/appos	reverse
X/NOUN/appos_<Y/NOUN/conj_>operator/NOUN/conj	reverse
X/NOUN/pobj_<Y/NOUN/conj_>bomb/NOUN/conj	reverse
pelagic/ADJ/amod<_X/NOUN/dobj_<as/ADP/prep_<Y/NOUN/pobj	reverse
pelagic/ADJ/amod<_X/NOUN/appos_<as/ADP/prep_<Y/NOUN/pobj	reverse
X/NOUN/appos_<as/ADP/prep_<Y/NOUN/pobj_>squid/NOUN/conj	reverse
such/ADJ/amod<_X/NOUN/pobj_<as/ADP/prep_<Y/NOUN/pobj	reverse
poor/ADJ/amod<_X/NOUN/appos_<Y/NOUN/conj	reverse
X/NOUN/ccomp_<as/ADP/prep_<Y/NOUN/pobj	reverse
school/VERB/amod<_X/NOUN/ccomp_<as/ADP/prep_<Y/NOUN/pobj	reverse
machine/NOUN/compound<_X/NOUN/conj_<Y/NOUN/conj	forward
X/NOUN/pobj_<system/NOUN/appos_<Y/NOUN/compound	reverse
farm/VERB/compound<_X/NOUN/dobj_<as/ADP/prep_<Y/NOUN/pobj	reverse
X/NOUN/dobj_<as/ADP/prep_<Y/NOUN/pobj_>trouser/NOUN/conj	reverse
X/NOUN/dobj_<call/VERB/acl_<Y/PROPN/oprd	reverse
predatory/ADJ/compound<_X/NOUN/pobj_<as/ADP/prep_<Y/NOUN/pobj	reverse
two/NUM/nummod<_X/NOUN/conj_<Y/NOUN/conj	forward
X/NOUN/conj_<system/NOUN/conj_<Y/NOUN/compound	forward
X/NOUN/nsubj>_jacket/NOUN/nsubj>_be/VERB/ROOT_<Y/NOUN/attr	forward
own/ADJ/amod<_X/NOUN/dobj_<Y/NOUN/appos	reverse
X/NOUN/dobj_<Y/NOUN/conj_>be/VERB/relcl	reverse
X/NOUN/dobj_<Y/NOUN/conj_>rocket/NOUN/conj	reverse
X/NOUN/conj_<be/VERB/relcl_<Y/NOUN/attr	forward
X/NOUN/conj_<weapon/NOUN/appos_<Y/NOUN/compound	reverse
the/DET/det<_X/NOUN/conj_<weapon/NOUN/appos_<Y/NOUN/compound	reverse
v-2/PROPN/punct<_X/NOUN/conj_<weapon/NOUN/appos_<Y/NOUN/compound	reverse
X/NOUN/nsubj_<Y/NOUN/appos_>of/ADP/prep	forward
X/NOUN/pobj_<tree/NOUN/conj_<Y/NOUN/compound	reverse
X/PROPN/conj_<castle/PROPN/conj_<Y/PROPN/conj	forward
X/NOUN/nsubj>_pear/NOUN/nsubj>_be/VERB/ROOT_<Y/NOUN/attr	forward
the/DET/det<_X/NOUN/conj_<as/ADP/prep_<Y/NOUN/pobj	forward
an/DET/det<_X/NOUN/conj_<Y/NOUN/conj	reverse
office/NOUN/compound<_X/NOUN/conj_<Y/NOUN/conj	reverse
X/NOUN/conj_<Y/NOUN/conj_>house/NOUN/conj	reverse
such/ADJ/amod<_X/NOUN/nsubjpass_<Y/NOUN/appos	reverse
X/NOUN/nsubjpass_<Y/NOUN/appos_>and/CCONJ/cc	reverse
outpatient/NOUN/compound<_X/NOUN/conj_<Y/NOUN/conj	reverse
clinic/NOUN/compound<_X/NOUN/conj_<Y/NOUN/conj	reverse
faculty/NOUN/compound<_X/NOUN/conj_<Y/NOUN/conj	reverse
X/NOUN/conj_<call/VERB/acl_<Y/PROPN/oprd	reverse
coldwater/NOUN/compound<_X/NOUN/pobj_<as/ADP/prep_<Y/NOUN/pobj	reverse
X/NOUN/nsubj>_pine/NOUN/nsubj>_be/VERB/ROOT_<Y/NOUN/attr	forward
light/ADJ/amod<_X/NOUN/appos_<Y/NOUN/conj	forward
assault/NOUN/compound<_X/NOUN/appos_<Y/NOUN/conj	forward
tank/NOUN/compound<_X/NOUN/conj_<Y/NOUN/conj	reverse
X/NOUN/nsubj>_phone/NOUN/nsubj>_be/VERB/ROOT_<Y/NOUN/attr	forward
X/NOUN/ROOT_<for/ADP/prep_<Y/NOUN/pobj	reverse
white/ADJ/amod<_X/NOUN/pobj_<Y/NOUN/conj	forward
own/ADJ/amod<_X/NOUN/pobj_<Y/NOUN/appos	reverse
X/NOUN/nsubj_<include/VERB/prep_<bruin/PROPN/pobj_<Y/PROPN/appos	reverse
X/NOUN/pobj_<Y/NOUN/conj_>from/ADP/prep	reverse
X/NOUN/conj_<Y/NOUN/conj_>satellite/NOUN/conj	forward
the/DET/det<_X/PROPN/nsubjpass_<Y/NOUN/conj	reverse
cell/NOUN/compound<_X/NOUN/pobj_<Y/NOUN/conj	forward
X/NOUN/pobj_<Y/NOUN/conj_>pda/NOUN/conj	forward
X/NOUN/pobj_<for/ADP/prep_<firing/NOUN/pcomp_<Y/NOUN/dobj	reverse
X/NOUN/nsubj_<like/ADP/prep_<Y/NOUN/pobj	reverse
X/PROPN/nsubj>_axe/PROPN/nsubj>_be/VERB/ROOT_<Y/NOUN/attr	forward
warwick/PROPN/compound<_X/PROPN/conj_<Y/PROPN/conj	forward
X/PROPN/conj_<Y/PROPN/conj_>house/PROPN/conj	forward
X/PROPN/appos_<Y/PROPN/appos	reverse
the/DET/det<_X/PROPN/appos_<Y/PROPN/appos	reverse
many/ADJ/amod<_X/NOUN/attr_<include/VERB/prep_<Y/NOUN/pobj	reverse
X/NOUN/dobj_<cm/ADP/appos_<Y/NOUN/appos	reverse
new/ADJ/amod<_X/NOUN/dobj_<cm/ADP/appos_<Y/NOUN/appos	reverse
six/NUM/nummod<_X/NOUN/dobj_<system/PROPN/conj_<Y/PROPN/compound	reverse
white/ADJ/amod<_X/NOUN/conj_<Y/NOUN/conj	forward
water/NOUN/compound<_X/NOUN/dobj_<Y/NOUN/appos	reverse
X/NOUN/compound>_fish/NOUN/compound>_Y/NOUN/ROOT	reverse
virgin/ADJ/amod<_X/NOUN/dobj_<be/VERB/relcl_<Y/NOUN/attr	forward
X/NOUN/dobj_<of/ADP/prep_<Y/NOUN/pobj_>in/ADP/prep	reverse
X/NOUN/attr_<with/ADP/prep_<engine/NOUN/pobj_<Y/NOUN/compound	forward
X/PROPN/compound>_pine/PROPN/compound>_school/PROPN/ROOT_<Y/PROPN/compound	forward
X/NOUN/nsubj>_food/NOUN/nsubj>_be/VERB/ROOT_<Y/NOUN/acomp	reverse
many/ADJ/amod<_X/NOUN/nsubj_<Y/NOUN/appos	reverse
cultured/ADJ/amod<_X/NOUN/nsubj_<Y/NOUN/appos	reverse
X/NOUN/compound>_fish/NOUN/compound>_specie/NOUN/ROOT_<Y/NOUN/intj	reverse
X/NOUN/dobj_<as/ADP/prep_<Y/NOUN/pobj_>and/CCONJ/cc	reverse
any/DET/det<_X/NOUN/pobj_<Y/NOUN/conj	forward
administration/PROPN/compound<_X/PROPN/pobj_<of/ADP/prep_<Y/PROPN/pobj	reverse
X/NOUN/nsubj>_rifle/NOUN/nsubj>_become/VERB/ROOT_<Y/NOUN/attr	forward
X/PROPN/nmod>_rocket/PROPN/nmod>_agency/PROPN/ROOT_<Y/PROPN/compound	reverse
X/NOUN/dobj_<Y/NOUN/appos_>on/ADP/prep	forward
X/NOUN/dobj_<include/VERB/prep_<pig/NOUN/pobj_<Y/NOUN/appos	reverse
new/ADJ/amod<_X/NOUN/dobj_<Y/NOUN/appos	forward
X/PROPN/nsubj>_weapon/PROPN/nsubj>_be/VERB/ROOT_<Y/NOUN/attr	reverse
X/PROPN/pobj_<at/ADP/prep_<Y/PROPN/pobj	reverse
the/DET/det<_X/PROPN/pobj_<at/ADP/prep_<Y/PROPN/pobj	reverse
X/NOUN/nsubj>_cod/NOUN/nsubj>_be/VERB/ROOT_<Y/NOUN/attr	forward
X/PROPN/nsubj>_gun/PROPN/nsubj>_be/VERB/ROOT_<Y/NOUN/attr	forward
-pron-/ADJ/poss<_X/NOUN/pobj_<Y/PROPN/appos	reverse
new/ADJ/amod<_X/NOUN/pobj_<Y/PROPN/appos	reverse
X/NOUN/pobj_<fish/NOUN/appos_<Y/NOUN/nmod	forward
the/DET/det<_X/NOUN/pobj_<fish/NOUN/appos_<Y/NOUN/nmod	forward
X/NOUN/pobj_<fish/NOUN/appos_<Y/NOUN/nmod_>and/CCONJ/cc	forward
X/NOUN/pobj_<fish/NOUN/appos_<Y/NOUN/nmod_>sport/NOUN/conj	forward
X/NOUN/dobj_<Y/NOUN/conj_>or/CCONJ/cc	forward
X/NOUN/attr_<Y/PROPN/appos	reverse
assault/NOUN/compound<_X/NOUN/conj_<Y/NOUN/conj	reverse
X/NOUN/pobj_<specie/NOUN/conj_<Y/NOUN/compound	forward
glove/PROPN/compound<_X/NOUN/conj_<Y/NOUN/conj	forward
air/NOUN/nmod<_X/NOUN/conj_<Y/NOUN/conj	forward
X/NOUN/attr_<for/ADP/prep_<Y/NOUN/pobj	reverse
land/NOUN/compound<_X/NOUN/nsubj_<as/ADP/prep_<Y/NOUN/pobj	reverse
proper/ADJ/amod<_X/NOUN/dobj_<of/ADP/prep_<Y/NOUN/pobj	reverse
-pron-/ADJ/poss<_X/NOUN/attr_<Y/NOUN/appos	forward
introduce/VERB/amod<_X/NOUN/pobj_<Y/NOUN/conj	forward
X/PROPN/nsubj_<Y/NOUN/appos_>build/VERB/acl	forward
X/PROPN/nsubj>_tree/PROPN/nsubj>_be/VERB/ROOT_<Y/PROPN/attr	reverse
fin/VERB/amod<_X/NOUN/pobj_<as/ADP/prep_<Y/NOUN/pobj	reverse
wild/ADJ/amod<_X/NOUN/nsubjpass_<as/ADP/prep_<Y/NOUN/pobj	reverse
class/NOUN/compound<_X/NOUN/pobj_<as/ADP/prep_<Y/NOUN/pobj	reverse
murray/PROPN/compound<_X/NOUN/pobj_<Y/NOUN/conj	forward
X/NOUN/nsubj>_produce/NOUN/nsubj>_be/VERB/ROOT_<Y/NOUN/attr	reverse
social/ADJ/amod<_X/NOUN/conj_<as/ADP/prep_<Y/NOUN/pobj	reverse
X/NOUN/conj_<as/ADP/prep_<Y/PROPN/pobj	reverse
X/NOUN/conj_<as/ADP/prep_<Y/PROPN/pobj_>and/CCONJ/cc	reverse
X/PROPN/pobj_<Y/NOUN/appos_>at/ADP/prep	forward
X/NOUN/pobj_<base/VERB/acl_<on/ADP/prep_<Y/NOUN/pobj	reverse
exist/VERB/amod<_X/NOUN/pobj_<Y/NOUN/conj	forward
hatchery/NOUN/compound<_X/NOUN/pobj_<Y/NOUN/conj	reverse
X/NOUN/pobj_<Y/NOUN/conj_>trout/NOUN/conj	reverse
X/NOUN/attr_<Y/NOUN/conj_>in/ADP/prep	forward
many/ADJ/amod<_X/NOUN/nsubj_<include/VERB/prep_<Y/NOUN/pobj	reverse
public/ADJ/amod<_X/NOUN/nsubj_<include/VERB/prep_<Y/NOUN/pobj	reverse
patrick/PROPN/poss<_X/PROPN/dobj_<Y/PROPN/conj	forward
X/PROPN/appos_<Y/PROPN/conj_>of/ADP/prep	forward
-pron-/ADJ/poss<_X/NOUN/dobj_<Y/PROPN/appos	forward
main/ADJ/amod<_X/NOUN/dobj_<Y/PROPN/appos	forward
X/NOUN/dobj_<with/ADP/prep_<Y/NOUN/pobj	forward
X/PROPN/conj_<Y/PROPN/conj_>at/ADP/prep	forward
X/NOUN/dobj_<include/VERB/prep_<Y/NOUN/pobj_>and/CCONJ/cc	reverse
X/NOUN/dobj_<include/VERB/prep_<Y/NOUN/pobj_>pant/NOUN/conj	reverse
X/NOUN/nsubj>_building/NOUN/nsubj>_house/VERB/ROOT_<Y/PROPN/dobj	reverse
X/NOUN/nsubj>_tree/NOUN/nsubj>_be/VERB/ROOT_<Y/PROPN/attr	reverse
X/NOUN/nsubj>_vessel/NOUN/nsubj>_be/VERB/ROOT_<Y/NOUN/attr	reverse
X/NOUN/pobj_<like/ADP/prep_<Y/NOUN/pobj_>or/CCONJ/cc	reverse
X/PROPN/compound>_pine/PROPN/compound>_trail/PROPN/ROOT_<Y/PROPN/compound	forward
native/ADJ/amod<_X/NOUN/pobj_<as/ADP/prep_<Y/NOUN/pobj	reverse
lake/NOUN/compound<_X/NOUN/pobj_<Y/NOUN/conj	forward
even/ADV/advmod<_X/NOUN/conj_<like/ADP/prep_<Y/NOUN/pobj	reverse
freshwater/NOUN/amod<_X/NOUN/conj_<like/ADP/prep_<Y/NOUN/pobj	reverse
X/NOUN/conj_<like/ADP/prep_<Y/NOUN/pobj_>and/CCONJ/cc	reverse
X/NOUN/nsubjpass_<of/ADP/prep_<Y/PROPN/pobj_>of/ADP/prep	forward
X/NOUN/pobj_<of/ADP/prep_<Y/PROPN/pobj_>and/CCONJ/cc	reverse
tall/ADJ/amod<_X/NOUN/pobj_<Y/NOUN/appos	reverse
X/PROPN/compound>_pine/PROPN/compound>_road/PROPN/ROOT_<Y/PROPN/compound	forward
X/NOUN/nsubj>_food/NOUN/nsubj>_include/VERB/ROOT_<Y/NOUN/dobj	reverse
X/NOUN/pobj_<as/ADP/prep_<Y/NOUN/pobj_>boat/NOUN/conj	reverse
X/NOUN/nsubjpass_<as/ADP/prep_<Y/NOUN/pobj_>whitefish/VERB/conj	reverse
freshwater/NOUN/amod<_X/NOUN/pobj_<Y/NOUN/appos	reverse
X/NOUN/dobj_<Y/NOUN/appos_>annihilate/VERB/relcl	forward
X/NOUN/attr_<of/ADP/prep_<Y/PROPN/pobj_>of/ADP/prep	reverse
some/DET/det<_X/NOUN/nsubjpass_<as/ADP/prep_<Y/NOUN/pobj	reverse
X/NOUN/appos_<wear/VERB/relcl_<drape/VERB/advcl_<Y/NOUN/nsubj	reverse
X/PROPN/attr_<castle/PROPN/conj_<Y/PROPN/conj	forward
X/PROPN/attr_<castle/PROPN/conj_<Y/PROPN/conj_>and/CCONJ/cc	forward
X/NOUN/pobj_<from/ADP/prep_<reindeer/PROPN/pobj_<Y/PROPN/conj	reverse
mm/NOUN/nmod<_X/NOUN/compound>_grenade/NOUN/compound>_Y/NOUN/ROOT	forward
automatic/ADJ/amod<_X/NOUN/compound>_grenade/NOUN/compound>_Y/NOUN/ROOT	forward
X/NOUN/nsubj>_bus/NOUN/nsubj>_be/VERB/ROOT_<Y/NOUN/attr	forward
X/PROPN/conj_<variety/NOUN/conj_<of/ADP/prep_<Y/NOUN/pobj	forward
X/NOUN/attr_<provide/VERB/relcl_<for/ADP/prep_<Y/NOUN/pobj	reverse
X/NOUN/dobj_<Y/NOUN/appos_>bayonet/NOUN/conj	reverse
X/NOUN/appos_<become/VERB/relcl_<Y/NOUN/attr	reverse
X/NOUN/attr_<consist/VERB/acl_<of/ADP/prep_<Y/NOUN/pobj	reverse
X/PROPN/pobj_<Y/NOUN/conj_>and/CCONJ/cc	forward
native/ADJ/amod<_X/NOUN/pobj_<include/VERB/prep_<Y/NOUN/pobj	reverse
passenger/NOUN/compound<_X/NOUN/attr_<Y/NOUN/conj	forward
assault/NOUN/compound<_X/NOUN/conj_<Y/NOUN/appos	forward
water/NOUN/nmod<_X/NOUN/attr_<as/ADP/prep_<Y/NOUN/pobj	reverse
oily/ADJ/amod<_X/NOUN/attr_<as/ADP/prep_<Y/NOUN/pobj	reverse
native/ADJ/amod<_X/NOUN/nsubjpass_<as/ADP/prep_<Y/NOUN/pobj	reverse
sport/NOUN/compound<_X/NOUN/nsubjpass_<as/ADP/prep_<Y/NOUN/pobj	reverse
X/NOUN/dobj_<than/ADP/prep_<Y/NOUN/pobj	reverse
X/NOUN/pobj_<as/ADP/prep_<Y/NOUN/pobj_>haddock/NOUN/conj	reverse
X/NOUN/pobj_<as/ADP/prep_<Y/NOUN/pobj_>herring/NOUN/conj	reverse
X/NOUN/nsubj>_tree/NOUN/nsubj>_be/VERB/ROOT_<Y/NOUN/acomp	reverse
automatic/ADJ/amod<_X/NOUN/pobj_<Y/NOUN/appos	reverse
X/NOUN/dobj_<variant/NOUN/appos_<of/ADP/prep_<Y/NOUN/pobj	forward
X/NOUN/dobj_<know/VERB/acl_<as/ADP/prep_<Y/NOUN/pobj	reverse
X/NOUN/nsubj>_ferry/NOUN/nsubj>_be/VERB/ROOT_<Y/NOUN/attr	forward
X/NOUN/pobj_<in/ADP/prep_<Y/NOUN/pobj	reverse
heroic/ADJ/amod<_X/NOUN/nsubjpass_<of/ADP/prep_<Y/NOUN/pobj	reverse
X/NOUN/compound>_table/NOUN/compound>_Y/NOUN/ROOT	forward
X/NOUN/nsubjpass>_salmon/NOUN/nsubjpass>_consider/VERB/ROOT_<Y/NOUN/oprd	forward
school/NOUN/compound<_X/NOUN/pobj_<Y/NOUN/conj	forward
X/NOUN/pobj_<Y/NOUN/conj_>of/ADP/prep	forward
X/NOUN/pobj_<include/VERB/prep_<Y/NOUN/pobj_>bass/NOUN/conj	reverse
the/DET/det<_X/NOUN/nsubj_<Y/PROPN/appos	reverse
standoff/NOUN/compound<_X/NOUN/pobj_<as/ADP/prep_<Y/NOUN/pobj	reverse
X/NOUN/pobj_<of/ADP/prep_<Y/NOUN/pobj_>in/ADP/prep	reverse
X/PROPN/compound>_pine/PROPN/compound>_landing/PROPN/ROOT_<Y/PROPN/compound	forward
the/DET/det<_X/NOUN/nsubjpass_<Y/PROPN/appos	reverse
first/ADJ/amod<_X/NOUN/nsubjpass_<Y/PROPN/appos	reverse
X/NOUN/pobj_<pike/INTJ/conj_<brook/NOUN/conj_<Y/NOUN/dobj	reverse
f-15/PROPN/punct<_X/PROPN/pobj_<Y/PROPN/conj	forward
X/PROPN/nsubj>_cod/PROPN/nsubj>_be/VERB/ROOT_<Y/NOUN/attr	forward
this/DET/det<_X/NOUN/nsubjpass_<Y/NOUN/appos	reverse
X/PROPN/compound>_weapon/PROPN/compound>_Y/NOUN/ROOT	reverse
m24/PROPN/compound<_X/PROPN/compound>_weapon/PROPN/compound>_Y/NOUN/ROOT	reverse
sniper/PROPN/compound<_X/PROPN/compound>_weapon/PROPN/compound>_Y/NOUN/ROOT	reverse
X/PROPN/ROOT_<be/VERB/conj_<Y/NOUN/attr	forward
X/NOUN/appos_<resemble/VERB/acl_<Y/NOUN/dobj	reverse
food/NOUN/compound<_X/NOUN/appos_<resemble/VERB/acl_<Y/NOUN/dobj	reverse
X/NOUN/attr_<construct/VERB/relcl_<Y/NOUN/nsubjpass	forward
the/DET/det<_X/NOUN/attr_<construct/VERB/relcl_<Y/NOUN/nsubjpass	forward
X/NOUN/compound>_vehicle/NOUN/compound>_system/NOUN/ROOT_<Y/NOUN/compound	reverse
X/NOUN/appos_<Y/PROPN/conj	forward
other/ADJ/amod<_X/NOUN/dobj_<include/VERB/prep_<Y/NOUN/pobj	reverse
X/NOUN/pobj_<weapon/NOUN/conj_<Y/NOUN/compound	reverse
X/NOUN/nsubj>_conifer/NOUN/nsubj>_include/VERB/ROOT_<Y/NOUN/dobj	reverse
X/NOUN/pobj_<Y/NOUN/appos_>in/ADP/prep	reverse
X/NOUN/nmod_<Y/NOUN/appos	reverse
large/ADJ/amod<_X/NOUN/nmod_<Y/NOUN/appos	reverse
X/PROPN/appos_<Y/PROPN/conj_>and/CCONJ/cc	forward
X/NOUN/pobj_<specie/NOUN/appos_<Y/NOUN/compound	reverse
large/ADJ/amod<_X/NOUN/pobj_<include/VERB/prep_<Y/NOUN/pobj	reverse
atomic/ADJ/amod<_X/NOUN/dobj_<Y/NOUN/appos	forward
X/NOUN/dobj_<Y/NOUN/appos_>of/ADP/prep	forward
X/NOUN/pobj_<with/ADP/prep_<Y/NOUN/pobj	reverse
large/ADJ/amod<_X/NOUN/dobj_<Y/NOUN/appos	forward
X/NOUN/appos_<call/VERB/acl_<Y/PROPN/oprd	reverse
familiar/ADJ/amod<_X/NOUN/nsubj_<Y/NOUN/appos	forward
modern/ADJ/amod<_X/NOUN/nsubj_<Y/NOUN/appos	forward
X/NOUN/nsubj_<Y/NOUN/appos_>dependent/ADJ/amod	forward
X/NOUN/nsubj_<Y/NOUN/appos_>and/CCONJ/cc	forward
X/NOUN/nsubj_<Y/NOUN/appos_>sport/VERB/conj	forward
first/ADJ/amod<_X/NOUN/nsubj_<Y/NOUN/conj	reverse
utility/NOUN/compound<_X/NOUN/conj_<Y/NOUN/conj	reverse
X/NOUN/compound>_animal/NOUN/compound>_life/NOUN/nsubj>_Y/NOUN/ROOT	reverse
X/NOUN/pobj_<other/ADJ/amod_<than/ADP/prep_<Y/NOUN/pobj	reverse
X/NOUN/nsubj_<know/VERB/acl_<as/ADP/prep_<Y/NOUN/pobj	forward
plasma/NOUN/compound<_X/NOUN/pobj_<Y/NOUN/appos	forward
X/NOUN/nsubj>_goldfish/NOUN/nsubj>_be/VERB/ROOT_<Y/NOUN/attr	forward
X/NOUN/attr_<Y/NOUN/appos_>or/CCONJ/cc	reverse
X/NOUN/conj_<include/VERB/prep_<Y/PROPN/pobj	reverse
X/NOUN/conj_<include/VERB/prep_<Y/PROPN/pobj_>chub/PROPN/conj	reverse
the/DET/det<_X/PROPN/nsubj_<Y/PROPN/conj	forward
the/DET/det<_X/NOUN/dobj_<Y/PROPN/appos	reverse
water/NOUN/compound<_X/NOUN/pobj_<as/ADP/prep_<Y/NOUN/pobj	reverse
X/NOUN/pobj_<as/ADP/prep_<Y/NOUN/pobj_>trout/NOUN/conj	reverse
X/NOUN/dobj_<stand/VERB/relcl_<than/ADP/prep_<Y/NOUN/pobj	reverse
dnepr-1/NOUN/compound<_X/NOUN/nsubjpass_<Y/NOUN/appos	reverse
X/PROPN/nsubj_<Y/NOUN/appos_>know/VERB/acl	forward
X/NOUN/nsubjpass>_animal/NOUN/nsubjpass>_call/VERB/ROOT_<Y/NOUN/oprd	reverse
X/NOUN/conj_<tree/NOUN/conj_<Y/PROPN/conj	reverse
X/NOUN/dobj_<Y/NOUN/conj_>in/ADP/prep	reverse
call/VERB/amod<_X/NOUN/attr_<include/VERB/prep_<Y/NOUN/pobj	reverse
poor/ADJ/amod<_X/NOUN/attr_<include/VERB/prep_<Y/NOUN/pobj	reverse
bark/NOUN/compound<_X/NOUN/attr_<include/VERB/prep_<Y/NOUN/pobj	reverse
grow/VERB/amod<_X/NOUN/attr_<as/ADP/prep_<Y/NOUN/pobj	reverse
thomas/PROPN/compound<_X/PROPN/dobj_<Y/NOUN/conj	forward
walker/PROPN/compound<_X/PROPN/dobj_<Y/NOUN/conj	forward
convalescent/PROPN/compound<_X/PROPN/dobj_<Y/NOUN/conj	forward
X/NOUN/nsubj_<as/ADP/prep_<Y/PROPN/pobj	reverse
laser/NOUN/compound<_X/NOUN/compound>_weapon/NOUN/compound>_Y/NOUN/ROOT	reverse
X/NOUN/nsubj>_garment/NOUN/nsubj>_include/VERB/ROOT_<Y/NOUN/dobj	reverse
class/NOUN/compound<_X/NOUN/nsubjpass_<with/ADP/prep_<Y/NOUN/pobj	forward
X/NOUN/ROOT_<Y/PROPN/appos	reverse
X/PROPN/compound>_pine/PROPN/compound>_riot/PROPN/ROOT_<Y/PROPN/compound	forward
X/PROPN/nsubj_<know/VERB/acl_<as/ADP/prep_<Y/PROPN/pobj	forward
X/NOUN/nsubj>_building/NOUN/nsubj>_replace/VERB/ROOT_<Y/PROPN/dobj	reverse
-pron-/ADJ/poss<_X/NOUN/dobj_<Y/NOUN/conj	reverse
the/DET/det<_X/NOUN/nsubjpass_<Y/NOUN/conj	forward
X/NOUN/conj_<Y/NOUN/conj_>motel/NOUN/conj	reverse
X/PROPN/compound>_pine/PROPN/compound>_company/PROPN/ROOT_<Y/PROPN/compound	forward
standard/ADJ/amod<_X/NOUN/conj_<Y/NOUN/conj	forward
X/NOUN/pobj_<Y/NOUN/appos_>trouser/NOUN/conj	reverse
X/NOUN/nsubjpass_<Y/NOUN/conj_>and/CCONJ/cc	forward
main/ADJ/amod<_X/NOUN/nsubjpass_<of/ADP/prep_<Y/NOUN/pobj	reverse
X/NOUN/nsubj>_device/NOUN/nsubj>_use/VERB/ROOT_<Y/NOUN/dobj	reverse
be/VERB/advcl<_X/NOUN/conj_<Y/NOUN/conj	forward
chandley/PROPN/compound<_X/NOUN/conj_<Y/NOUN/conj	forward
class/NOUN/compound<_X/NOUN/conj_<Y/NOUN/conj	forward
municipal/ADJ/amod<_X/NOUN/conj_<Y/NOUN/conj	reverse
three/NUM/nummod<_X/NOUN/pobj_<Y/NOUN/conj	forward
X/PROPN/compound>_hotel/PROPN/compound>_Y/NOUN/ROOT	forward
the/DET/det<_X/NOUN/dobj_<as/ADP/prep_<Y/PROPN/pobj	reverse
X/PROPN/nsubj>_fruit/PROPN/nsubj>_include/VERB/ROOT_<Y/NOUN/dobj	reverse
X/NOUN/poss>_missile/NOUN/poss>_motor/NOUN/ROOT_<Y/NOUN/compound	forward
second/ADJ/amod<_X/NOUN/dobj_<Y/NOUN/appos	forward
turkish/ADJ/amod<_X/NOUN/dobj_<Y/NOUN/appos	forward
X/NOUN/dobj_<Y/NOUN/appos_>build/VERB/acl	forward
X/NOUN/pobj_<in/ADP/prep_<Y/PROPN/pobj	reverse
tower/NOUN/compound<_X/NOUN/attr_<Y/NOUN/conj	reverse
X/NOUN/attr_<Y/NOUN/conj_>build/VERB/relcl	reverse
X/NOUN/nsubj>_plum/NOUN/nsubj>_be/VERB/ROOT_<Y/NOUN/attr	forward
X/NOUN/dep_<Y/NOUN/conj	forward
the/DET/det<_X/NOUN/dep_<Y/NOUN/conj	forward
type/PROPN/nmod<_X/NOUN/attr_<Y/NOUN/appos	forward
other/ADJ/amod<_X/NOUN/pobj_<like/ADP/prep_<Y/NOUN/pobj	reverse
the/DET/det<_X/NOUN/dobj_<like/ADP/prep_<Y/NOUN/pobj	reverse
X/PROPN/compound>_castle/PROPN/compound>_Y/PROPN/ROOT	forward
X/PROPN/conj_<house/PROPN/conj_<Y/PROPN/compound	reverse
the/DET/det<_X/PROPN/conj_<house/PROPN/conj_<Y/PROPN/compound	reverse
georgian/PROPN/compound<_X/PROPN/conj_<house/PROPN/conj_<Y/PROPN/compound	reverse
real/ADJ/amod<_X/NOUN/pobj_<include/VERB/prep_<Y/NOUN/pobj	reverse
X/NOUN/compound>_boat/NOUN/compound>_service/NOUN/ROOT_<Y/NOUN/compound	reverse
X/PROPN/nsubj_<Y/PROPN/appos	reverse
the/DET/det<_X/PROPN/nsubj_<Y/PROPN/appos	reverse
X/NOUN/dobj_<Y/NOUN/appos_>in/ADP/prep	reverse
X/NOUN/nsubj_<as/ADP/prep_<Y/NOUN/pobj_>and/CCONJ/cc	reverse
game/NOUN/compound<_X/NOUN/nsubj_<as/ADP/prep_<Y/NOUN/pobj	reverse
coarse/ADJ/amod<_X/NOUN/pobj_<as/ADP/prep_<Y/NOUN/pobj	reverse
the/DET/det<_X/NOUN/dobj_<in/ADP/prep_<Y/NOUN/pobj	forward
black/ADJ/amod<_X/NOUN/appos_<include/VERB/prep_<Y/NOUN/pobj	reverse
smart/ADJ/amod<_X/NOUN/appos_<include/VERB/prep_<Y/NOUN/pobj	reverse
X/NOUN/nsubj>_fruit/NOUN/nsubj>_be/VERB/ROOT_<Y/NOUN/attr	reverse
domesticate/VERB/amod<_X/NOUN/pobj_<as/ADP/prep_<Y/NOUN/pobj	reverse
X/PROPN/conj_<building/PROPN/conj_<Y/PROPN/conj	reverse
the/DET/det<_X/PROPN/conj_<building/PROPN/conj_<Y/PROPN/conj	reverse
X/PROPN/nsubj>_gorilla/PROPN/nsubj>_be/VERB/ROOT_<Y/NOUN/attr	forward
X/NOUN/nsubjpass>_building/NOUN/nsubjpass>_call/VERB/ROOT_<Y/PROPN/oprd	reverse
X/NOUN/nsubj>_hotel/NOUN/nsubj>_offer/VERB/ROOT_<Y/NOUN/dobj	forward
X/PROPN/compound>_willow/PROPN/compound>_Y/PROPN/ROOT	forward
new/ADJ/amod<_X/NOUN/pobj_<of/ADP/prep_<Y/PROPN/pobj	reverse
X/NOUN/pobj_<Y/NOUN/conj_>fire/NOUN/conj	forward
conventional/ADJ/amod<_X/NOUN/pobj_<Y/NOUN/conj	forward
small/ADJ/amod<_X/NOUN/attr_<Y/NOUN/conj	reverse
sandringham/PROPN/compound<_X/PROPN/appos_<Y/PROPN/conj	reverse
X/NOUN/nsubj>_fish/NOUN/nsubj>_Y/NOUN/ROOT	reverse
hold/VERB/amod<_X/NOUN/pobj_<as/ADP/prep_<Y/NOUN/pobj	reverse
an/DET/det<_X/NOUN/attr_<for/ADP/prep_<Y/NOUN/pobj	reverse
X/NOUN/dobj_<use/VERB/acl_<as/ADP/prep_<Y/NOUN/pobj	forward
X/NOUN/conj_<of/ADP/prep_<cactus/NOUN/pobj_<Y/NOUN/compound	reverse
X/NOUN/pobj_<for/ADP/prep_<Y/PROPN/pobj	reverse
manor/NOUN/compound<_X/NOUN/pobj_<call/VERB/acl_<Y/PROPN/oprd	reverse
X/NOUN/pobj_<call/VERB/acl_<Y/PROPN/oprd_>own/VERB/relcl	reverse
X/NOUN/pobj_<like/ADP/prep_<Y/NOUN/pobj_>peach/NOUN/conj	reverse
automatic/ADJ/amod<_X/NOUN/dobj_<Y/NOUN/conj	reverse
anthropomorphic/ADJ/amod<_X/NOUN/pobj_<include/VERB/prep_<Y/NOUN/pobj	reverse
X/NOUN/nsubj>_mackerel/NOUN/nsubj>_be/VERB/ROOT_<Y/NOUN/attr	forward
X/NOUN/dobj_<as/ADP/prep_<Y/PROPN/pobj_>and/CCONJ/cc	reverse
X/NOUN/pobj_<of/ADP/prep_<Y/NOUN/pobj_>and/CCONJ/cc	reverse
X/NOUN/conj_<Y/NOUN/conj_>in/ADP/prep	reverse
X/NOUN/conj_<in/ADP/prep_<Y/NOUN/pobj	forward
X/NOUN/compound>_rifle/NOUN/compound>_Y/NOUN/ROOT	forward
X/NOUN/pobj_<line/NOUN/conj_<Y/NOUN/compound	reverse
X/NOUN/conj_<Y/NOUN/appos_>in/ADP/prep	reverse
X/NOUN/pobj_<specie/NOUN/conj_<of/ADP/prep_<Y/NOUN/pobj	forward
sacred/ADJ/amod<_X/NOUN/pobj_<Y/NOUN/appos	reverse
small/ADJ/amod<_X/NOUN/pobj_<as/ADP/prep_<Y/NOUN/pobj	reverse
aleppo/NOUN/compound<_X/NOUN/conj_<Y/NOUN/conj	forward
plum/NOUN/compound<_X/NOUN/conj_<Y/NOUN/conj	reverse
X/NOUN/conj_<Y/NOUN/conj_>tree/NOUN/conj	reverse
X/NOUN/conj_<fund/VERB/conj_<Y/NOUN/dobj	reverse
X/NOUN/pobj_<include/VERB/relcl_<Y/NOUN/dobj	reverse
traditional/ADJ/amod<_X/NOUN/pobj_<include/VERB/relcl_<Y/NOUN/dobj	reverse
X/NOUN/dobj_<from/ADP/prep_<Y/NOUN/pobj	reverse
an/DET/det<_X/NOUN/appos_<Y/NOUN/conj	reverse
X/NOUN/conj_<Y/NOUN/conj_>vehicle/NOUN/conj	reverse
X/NOUN/pobj_<fir/NOUN/conj_<specie/NOUN/conj_<Y/NOUN/compound	forward
X/NOUN/conj_<forest/NOUN/dobj_<of/ADP/prep_<Y/NOUN/pobj	reverse
such/ADJ/amod<_X/NOUN/dobj_<as/ADP/prep_<Y/PROPN/pobj	reverse
X/NOUN/dobj_<lau-3/ADJ/conj_<launcher/NOUN/conj_<Y/NOUN/compound	forward
X/NOUN/compound>_weapon/NOUN/compound>_system/NOUN/ROOT_<Y/NOUN/appos	reverse
type/NOUN/nmod<_X/NOUN/pobj_<Y/NOUN/appos	forward
X/PROPN/conj_<Y/PROPN/conj_>university/PROPN/conj	reverse
X/NOUN/dobj_<on/ADP/prep_<Y/NOUN/pobj	reverse
X/PROPN/pobj_<Y/NOUN/appos_>build/VERB/acl	forward
pre/PROPN/nmod<_X/NOUN/pobj_<Y/NOUN/conj	reverse
clinical/PROPN/amod<_X/NOUN/pobj_<Y/NOUN/conj	reverse
X/NOUN/amod>_pine/NOUN/amod>_plantation/NOUN/ROOT_<Y/NOUN/compound	forward
X/NOUN/nsubj>_train/NOUN/nsubj>_hit/VERB/ROOT_<Y/NOUN/dobj	forward
X/NOUN/amod>_pine/NOUN/amod>_stump/NOUN/ROOT_<Y/NOUN/compound	forward
all/DET/det<_X/NOUN/pobj_<include/VERB/prep_<Y/NOUN/pobj	reverse
gladesville/PROPN/compound<_X/PROPN/pobj_<Y/NOUN/conj	forward
mental/PROPN/compound<_X/PROPN/pobj_<Y/NOUN/conj	forward
X/PROPN/conj_<cathedral/PROPN/conj_<Y/PROPN/conj	forward
radiation/NOUN/compound<_X/NOUN/pobj_<Y/PROPN/appos	forward
former/ADJ/amod<_X/NOUN/pobj_<Y/NOUN/conj	forward
psychiatric/ADJ/amod<_X/NOUN/pobj_<Y/NOUN/conj	forward
large/ADJ/amod<_X/NOUN/conj_<Y/NOUN/conj	reverse
the/DET/det<_X/NOUN/pobj_<in/ADP/prep_<Y/NOUN/pobj	reverse
X/NOUN/pobj_<from/ADP/prep_<Y/NOUN/pobj	reverse
X/NOUN/dobj_<of/ADP/prep_<Y/NOUN/pobj_>and/CCONJ/cc	reverse
X/NOUN/nsubj>_rocket/NOUN/nsubj>_be/VERB/ROOT_<Y/NOUN/attr	reverse
X/NOUN/conj_<computer/NOUN/conj_<Y/NOUN/acl	forward
mobile/ADJ/amod<_X/NOUN/conj_<computer/NOUN/conj_<Y/NOUN/acl	forward
X/NOUN/pobj_<launcher/NOUN/conj_<Y/NOUN/compound	reverse
X/NOUN/dobj_<ousel/NOUN/appos_<Y/NOUN/appos	reverse
several/ADJ/amod<_X/NOUN/dobj_<ousel/NOUN/appos_<Y/NOUN/appos	reverse
X/NOUN/conj_<with/ADP/prep_<Y/NOUN/pobj	forward
an/DET/det<_X/NOUN/nsubj_<Y/NOUN/appos	forward
X/PROPN/ROOT_<as/ADP/prep_<Y/NOUN/pobj	forward
X/NOUN/pobj_<as/ADP/prep_<launcher/NOUN/pobj_<Y/NOUN/compound	reverse
serve/VERB/amod<_X/NOUN/pobj_<as/ADP/prep_<Y/NOUN/pobj	reverse
X/NOUN/pobj_<Y/NOUN/conj_>torpedo/NOUN/conj	forward
first/ADJ/amod<_X/NOUN/conj_<Y/NOUN/conj	forward
transportation/NOUN/compound<_X/NOUN/nsubj_<Y/NOUN/conj	reverse
mount/VERB/amod<_X/NOUN/pobj_<Y/NOUN/conj	reverse
X/PROPN/compound>_apple/PROPN/compound>_pie/PROPN/ROOT_<Y/PROPN/conj	forward
X/NOUN/pobj_<Y/NOUN/conj_>gun/NOUN/conj	reverse
second/ADJ/amod<_X/NOUN/attr_<Y/NOUN/conj	forward
X/NOUN/attr_<Y/NOUN/appos_>with/ADP/prep	forward
dog/NOUN/compound<_X/NOUN/conj_<Y/NOUN/conj	reverse
mm/NOUN/nmod<_X/NOUN/attr_<Y/NOUN/appos	forward
host/NOUN/compound<_X/NOUN/attr_<Y/NOUN/conj	reverse
X/PROPN/appos_<Y/PROPN/conj_>in/ADP/prep	reverse
X/NOUN/ROOT_<w47/PROPN/appos_<w55/NOUN/conj_<Y/NOUN/parataxis	forward
X/NOUN/pobj_<carry/VERB/acl_<on/ADP/prep_<Y/NOUN/pobj	reverse
all/ADJ/predet<_X/NOUN/nsubj_<Y/NOUN/conj	reverse
fry/VERB/amod<_X/NOUN/pobj_<Y/NOUN/appos	reverse
small/ADJ/amod<_X/NOUN/pobj_<like/ADP/prep_<Y/NOUN/pobj	reverse
X/NOUN/pobj_<Y/NOUN/appos_>for/ADP/prep	reverse
balmoral/PROPN/compound<_X/PROPN/pobj_<Y/PROPN/conj	forward
especially/ADV/advmod<_X/NOUN/appos_<Y/NOUN/conj	reverse
nuclear/ADJ/amod<_X/NOUN/dobj_<Y/NOUN/appos	reverse
X/NOUN/nsubj_<Y/NOUN/conj_>of/ADP/prep	forward
popular/ADJ/amod<_X/NOUN/pobj_<as/ADP/prep_<Y/NOUN/pobj	reverse
the/DET/det<_X/NOUN/nsubj_<as/ADP/prep_<Y/NOUN/pobj	reverse
X/PROPN/dobj_<Y/PROPN/appos	forward
the/DET/det<_X/PROPN/dobj_<Y/PROPN/appos	forward
two/NUM/nummod<_X/NOUN/dobj_<Y/NOUN/appos	reverse
compete/VERB/amod<_X/NOUN/dobj_<Y/NOUN/appos	reverse
tank/NOUN/compound<_X/NOUN/dobj_<Y/NOUN/appos	reverse
X/PROPN/compound>_pine/PROPN/compound>_camp/PROPN/ROOT_<Y/PROPN/compound	forward
X/PROPN/pobj_<of/ADP/prep_<Y/NOUN/pobj	reverse
the/DET/det<_X/PROPN/pobj_<of/ADP/prep_<Y/NOUN/pobj	reverse
X/NOUN/nsubj>_arm/NOUN/nsubj>_mount/VERB/ROOT_<Y/NOUN/advcl	reverse
X/NOUN/compound>_bus/NOUN/compound>_Y/NOUN/ROOT	forward
X/NOUN/conj_<Y/NOUN/conj_>with/ADP/prep	forward
endanger/VERB/amod<_X/NOUN/pobj_<like/ADP/prep_<Y/NOUN/pobj	reverse
X/NOUN/nsubj>_castle/NOUN/nsubj>_have/VERB/ROOT_<Y/NOUN/dobj	forward
X/NOUN/compound>_fish/NOUN/compound>_population/NOUN/ROOT_<Y/PROPN/appos	reverse
X/NOUN/appos_<launch/VERB/relcl_<Y/NOUN/dobj	reverse
solid/ADJ/amod<_X/NOUN/appos_<launch/VERB/relcl_<Y/NOUN/dobj	reverse
propellant/ADJ/amod<_X/NOUN/appos_<launch/VERB/relcl_<Y/NOUN/dobj	reverse
booster/NOUN/compound<_X/NOUN/appos_<launch/VERB/relcl_<Y/NOUN/dobj	reverse
X/NOUN/attr_<in/ADP/prep_<family/NOUN/pobj_<Y/NOUN/compound	reverse
the/DET/det<_X/PROPN/ROOT_<Y/NOUN/appos	forward
X/NOUN/compound>_fruit/NOUN/compound>_flavour/VERB/ROOT_<Y/NOUN/appos	reverse
X/PROPN/dobj_<gillybrands/PROPN/conj_<Y/PROPN/conj	reverse
elsick/PROPN/compound<_X/PROPN/dobj_<gillybrands/PROPN/conj_<Y/PROPN/conj	reverse
X/NOUN/compound>_device/NOUN/compound>_â/X/ROOT_<Y/NOUN/dobj	reverse
large/ADJ/amod<_X/NOUN/dobj_<Y/NOUN/conj	forward
X/NOUN/appos_<from/ADP/prep_<river/NOUN/pobj_<Y/NOUN/appos	reverse
X/NOUN/pobj_<sink/VERB/acl_<by/ADP/agent_<Y/NOUN/pobj	reverse
X/NOUN/nsubj>_missile/NOUN/nsubj>_carry/VERB/ROOT_<Y/NOUN/dobj	forward
X/NOUN/dobj_<include/VERB/prep_<story/NOUN/pobj_<Y/PROPN/appos	reverse
X/NOUN/dobj_<give/VERB/relcl_<Y/NOUN/dobj	reverse
incendiary/ADJ/amod<_X/NOUN/dobj_<give/VERB/relcl_<Y/NOUN/dobj	reverse
X/NOUN/attr_<on/ADP/prep_<Y/NOUN/pobj	reverse
X/NOUN/pobj_<as/ADP/prep_<Y/NOUN/pobj_>wolf/NOUN/conj	reverse
the/DET/det<_X/PROPN/attr_<Y/NOUN/appos	forward
crab/NOUN/compound<_X/NOUN/conj_<Y/NOUN/conj	forward
X/NOUN/compound>_rocket/NOUN/compound>_propel/NOUN/ROOT_<Y/NOUN/npadvmod	reverse
fleshy/ADJ/amod<_X/NOUN/pobj_<like/ADP/prep_<Y/NOUN/pobj	reverse
X/NOUN/dobj_<system/PROPN/appos_<Y/PROPN/compound	forward
either/CCONJ/preconj<_X/NOUN/dobj_<system/PROPN/appos_<Y/PROPN/compound	forward
the/DET/det<_X/NOUN/dobj_<system/PROPN/appos_<Y/PROPN/compound	forward
hellfire/PROPN/compound<_X/NOUN/dobj_<system/PROPN/appos_<Y/PROPN/compound	forward
migratory/ADJ/amod<_X/NOUN/pobj_<as/ADP/prep_<Y/NOUN/pobj	reverse
X/NOUN/conj_<pike/INTJ/conj_<Y/NOUN/conj_>or/CCONJ/cc	reverse
X/NOUN/conj_<pike/INTJ/conj_<Y/NOUN/conj_>salmon/NOUN/conj	reverse
X/NOUN/nsubj>_fruit/NOUN/nsubj>_Y/NOUN/ROOT	reverse
various/ADJ/amod<_X/NOUN/nmod_<Y/NOUN/conj	reverse
range/NOUN/compound<_X/NOUN/nmod_<Y/NOUN/conj	reverse
X/NOUN/nmod_<Y/NOUN/conj_>or/CCONJ/cc	reverse
X/NOUN/nsubj>_clothing/NOUN/nsubj>_be/VERB/ROOT_<Y/NOUN/attr	reverse
X/NOUN/pobj_<pension/PROPN/appos_<Y/PROPN/conj	reverse
-pron-/ADJ/poss<_X/NOUN/pobj_<pension/PROPN/appos_<Y/PROPN/conj	reverse
century/NOUN/nmod<_X/NOUN/pobj_<pension/PROPN/appos_<Y/PROPN/conj	reverse
italian/ADJ/amod<_X/NOUN/pobj_<pension/PROPN/appos_<Y/PROPN/conj	reverse
X/NOUN/pobj_<pension/PROPN/appos_<Y/PROPN/conj_>and/CCONJ/cc	reverse
X/NOUN/pobj_<pension/PROPN/appos_<Y/PROPN/conj_>house/PROPN/conj	reverse
X/NOUN/pobj_<pension/PROPN/appos_<building/PROPN/conj_<Y/PROPN/conj	reverse
X/NOUN/pobj_<Y/NOUN/conj_>fish/NOUN/conj	forward
twelve/NUM/nummod<_X/NOUN/nsubj>_animal/NOUN/nsubj>_Y/NOUN/ROOT	reverse
balmoral/PROPN/compound<_X/PROPN/conj_<Y/PROPN/conj	forward
X/NOUN/attr_<include/VERB/prep_<migaloo/PROPN/pobj_<Y/NOUN/appos	reverse
X/NOUN/nsubj_<size/NOUN/appos_<of/ADP/prep_<Y/NOUN/pobj	reverse
X/NOUN/conj_<Y/NOUN/conj_>for/ADP/prep	forward
X/NOUN/attr_<of/ADP/prep_<Y/PROPN/pobj_>and/CCONJ/cc	reverse
X/NOUN/attr_<of/ADP/prep_<Y/PROPN/pobj_>center/PROPN/conj	reverse
X/PROPN/attr_<Y/NOUN/appos_>and/CCONJ/cc	forward
X/NOUN/compound>_vehicle/NOUN/compound>_standard/NOUN/ROOT_<Y/NOUN/compound	reverse
artillery/NOUN/compound<_X/NOUN/conj_<system/NOUN/conj_<Y/NOUN/compound	reverse
X/PROPN/dobj_<Y/NOUN/appos_>in/ADP/prep	forward
starkist/NOUN/amod<_X/NOUN/pobj_<Y/NOUN/conj	forward
X/NOUN/nsubj>_fish/NOUN/nsubj>_be/VERB/ROOT_<Y/PROPN/attr	reverse
X/NOUN/pobj_<cut/VERB/acl_<to/ADP/prep_<Y/NOUN/pobj	reverse
X/NOUN/nsubj>_rocket/NOUN/nsubj>_place/VERB/ROOT_<Y/NOUN/npadvmod	reverse
muchalls/PROPN/compound<_X/PROPN/pobj_<Y/PROPN/conj	forward
pershing/PROPN/compound<_X/NOUN/pobj_<Y/NOUN/conj	forward
X/NOUN/nsubj>_fruit/NOUN/nsubj>_include/VERB/ROOT_<Y/NOUN/dobj	reverse
X/PROPN/compound>_pine/PROPN/compound>_Y/PROPN/ROOT	forward
the/DET/det<_X/PROPN/attr_<Y/NOUN/conj	forward
X/PROPN/attr_<Y/NOUN/conj_>of/ADP/prep	forward
X/NOUN/compound>_apple/NOUN/compound>_Y/NOUN/ROOT	forward
goddard/PROPN/poss<_X/NOUN/pobj_<Y/PROPN/conj	reverse
prototype/NOUN/nmod<_X/NOUN/pobj_<Y/PROPN/conj	reverse
liquid/NOUN/nmod<_X/NOUN/pobj_<Y/PROPN/conj	reverse
fueled/ADJ/amod<_X/NOUN/pobj_<Y/PROPN/conj	reverse
hill/PROPN/compound<_X/PROPN/pobj_<Y/PROPN/conj	reverse
X/NOUN/pobj_<from/ADP/prep_<by/ADP/conj_<Y/NOUN/pobj	forward
X/NOUN/poss>_hospital/NOUN/poss>_Y/NOUN/ROOT_>and/CCONJ/cc	forward
X/PROPN/compound>_pine/PROPN/compound>_festival/PROPN/ROOT_<Y/PROPN/compound	forward
X/PROPN/nsubjpass_<of/ADP/prep_<Y/PROPN/pobj	reverse
the/DET/det<_X/PROPN/nsubjpass_<of/ADP/prep_<Y/PROPN/pobj	reverse
former/ADJ/amod<_X/PROPN/nsubjpass_<of/ADP/prep_<Y/PROPN/pobj	reverse
arsenal/NOUN/amod<_X/PROPN/nsubjpass_<of/ADP/prep_<Y/PROPN/pobj	reverse
administration/PROPN/compound<_X/PROPN/nsubjpass_<of/ADP/prep_<Y/PROPN/pobj	reverse
exotic/ADJ/amod<_X/NOUN/pobj_<include/VERB/relcl_<Y/NOUN/dobj	reverse
main/ADJ/amod<_X/NOUN/pobj_<of/ADP/prep_<Y/NOUN/pobj	reverse
X/NOUN/pobj_<at/ADP/prep_<Y/PROPN/pobj	forward
the/DET/det<_X/NOUN/pobj_<at/ADP/prep_<Y/PROPN/pobj	forward
historic/ADJ/amod<_X/NOUN/conj_<Y/NOUN/conj	reverse
X/NOUN/conj_<Y/NOUN/conj_>abbey/NOUN/conj	reverse
X/NOUN/nsubjpass_<name/VERB/acl_<Y/PROPN/oprd	forward
the/DET/det<_X/NOUN/nsubjpass_<name/VERB/acl_<Y/PROPN/oprd	forward
X/PROPN/nsubj_<Y/NOUN/appos_>with/ADP/prep	forward
X/NOUN/conj_<Y/NOUN/conj_>specie/NOUN/conj	forward
hamilton/PROPN/compound<_X/PROPN/conj_<Y/PROPN/conj	forward
X/PROPN/conj_<Y/PROPN/conj_>hall/PROPN/conj	forward
X/NOUN/attr_<call/VERB/acl_<Y/PROPN/oprd	reverse
X/NOUN/compound>_animal/NOUN/compound>_product/NOUN/ROOT_<Y/NOUN/appos	reverse
X/NOUN/pobj_<of/ADP/prep_<school/PROPN/pobj_<Y/PROPN/compound	reverse
wwii/PROPN/compound<_X/NOUN/pobj_<like/ADP/prep_<Y/NOUN/pobj	reverse
infantry/NOUN/compound<_X/NOUN/pobj_<like/ADP/prep_<Y/NOUN/pobj	reverse
soviet/PROPN/compound<_X/NOUN/pobj_<like/ADP/prep_<Y/NOUN/pobj	reverse
administration/NOUN/compound<_X/NOUN/conj_<Y/NOUN/conj	reverse
X/PROPN/compound>_birch/PROPN/compound>_group/PROPN/ROOT_<Y/PROPN/compound	forward
X/NOUN/nsubj>_rifle/NOUN/nsubj>_remain/VERB/ROOT_<Y/NOUN/attr	forward
land/NOUN/compound<_X/NOUN/pobj_<as/ADP/prep_<Y/NOUN/pobj	reverse
plant/VERB/amod<_X/NOUN/attr_<Y/NOUN/conj	reverse
ornamental/ADJ/amod<_X/NOUN/attr_<Y/NOUN/conj	reverse
X/NOUN/nsubj>_animal/NOUN/nsubj>_be/VERB/ROOT_<Y/PROPN/attr	reverse
X/NOUN/dobj_<over/ADP/prep_<Y/NOUN/pobj	forward
X/NOUN/pobj_<include/VERB/prep_<Y/PROPN/pobj	reverse
communication/NOUN/compound<_X/NOUN/nsubj_<as/ADP/prep_<Y/NOUN/pobj	reverse
X/NOUN/nsubj_<as/ADP/prep_<Y/NOUN/pobj_>or/CCONJ/cc	reverse
X/NOUN/ROOT_<of/ADP/prep_<Y/PROPN/pobj	reverse
the/DET/det<_X/NOUN/ROOT_<of/ADP/prep_<Y/PROPN/pobj	reverse
worldâs/ADJ/amod<_X/NOUN/pobj_<Y/NOUN/appos	forward
ballistic/ADJ/amod<_X/NOUN/pobj_<Y/NOUN/appos	forward
either/CCONJ/preconj<_X/NOUN/dobj_<Y/NOUN/conj	reverse
rainbow/ADJ/compound<_X/NOUN/dobj_<Y/NOUN/conj	reverse
cat/NOUN/compound<_X/NOUN/conj_<Y/NOUN/conj	reverse
X/PROPN/attr_<castle/PROPN/conj_<castle/PROPN/conj_<Y/PROPN/conj	forward
commando/NOUN/compound<_X/NOUN/conj_<Y/NOUN/conj	reverse
cross/VERB/compound<_X/NOUN/conj_<Y/NOUN/conj	forward
country/NOUN/compound<_X/NOUN/conj_<Y/NOUN/conj	forward
X/NOUN/attr_<fry/NOUN/conj_<Y/NOUN/appos	reverse
the/DET/det<_X/NOUN/attr_<fry/NOUN/conj_<Y/NOUN/appos	reverse
featured/ADJ/amod<_X/NOUN/attr_<fry/NOUN/conj_<Y/NOUN/appos	reverse
other/ADJ/amod<_X/NOUN/nsubj_<as/ADP/prep_<Y/NOUN/pobj	reverse
m240b/PROPN/compound<_X/PROPN/conj_<Y/PROPN/conj	forward
machine/PROPN/compound<_X/PROPN/conj_<Y/PROPN/conj	forward
X/PROPN/nsubj_<Y/PROPN/conj_>and/CCONJ/cc	forward
X/PROPN/nsubj_<building/PROPN/conj_<Y/PROPN/conj	forward
the/DET/det<_X/PROPN/nsubj_<building/PROPN/conj_<Y/PROPN/conj	forward
X/NOUN/compound>_missile/NOUN/compound>_system/NOUN/ROOT_<Y/NOUN/appos	forward
virtuaroid/PROPN/poss<_X/NOUN/attr_<Y/NOUN/appos	reverse
main/ADJ/amod<_X/NOUN/attr_<Y/NOUN/appos	reverse
X/NOUN/nsubjpass_<Y/PROPN/conj	reverse
X/NOUN/compound>_acacia/NOUN/compound>_Y/NOUN/ROOT	forward
X/NOUN/pobj_<Y/NOUN/appos_>dog/NOUN/conj	reverse
X/PROPN/compound>_pine/PROPN/compound>_council/PROPN/ROOT_<Y/PROPN/compound	forward
small/ADJ/amod<_X/NOUN/pobj_<Y/NOUN/conj	reverse
X/PROPN/conj_<Y/PROPN/conj_>building/PROPN/conj	forward
X/NOUN/pobj_<resemble/VERB/relcl_<Y/NOUN/dobj	forward
X/PROPN/nsubj>_hotel/PROPN/nsubj>_offer/VERB/ROOT_<Y/NOUN/dobj	forward
X/PROPN/nsubjpass_<know/VERB/acl_<as/ADP/prep_<Y/PROPN/pobj	reverse
X/PROPN/dobj_<cary/PROPN/appos_<Y/PROPN/compound	reverse
the/DET/det<_X/PROPN/dobj_<cary/PROPN/appos_<Y/PROPN/compound	reverse
manor/PROPN/compound<_X/PROPN/dobj_<cary/PROPN/appos_<Y/PROPN/compound	reverse
X/NOUN/pobj_<project/NOUN/appos_<Y/NOUN/nmod	reverse
-pron-/ADJ/poss<_X/NOUN/pobj_<project/NOUN/appos_<Y/NOUN/nmod	reverse
winged/ADJ/amod<_X/NOUN/pobj_<project/NOUN/appos_<Y/NOUN/nmod	reverse
X/NOUN/attr_<hotel/PROPN/appos_<Y/PROPN/compound	reverse
public/ADJ/amod<_X/NOUN/attr_<hotel/PROPN/appos_<Y/PROPN/compound	reverse
X/NOUN/nsubj>_furniture/NOUN/nsubj>_include/VERB/ROOT_<Y/NOUN/dobj	reverse
primary/ADJ/amod<_X/NOUN/appos_<Y/NOUN/appos	reverse
primary/ADJ/amod<_X/NOUN/nmod>_animal/NOUN/nmod>_Y/NOUN/ROOT	reverse
base/VERB/amod<_X/NOUN/pobj_<Y/NOUN/conj	reverse
nylon/PROPN/compound<_X/NOUN/attr_<Y/NOUN/appos	reverse
X/NOUN/pobj_<become/VERB/relcl_<Y/NOUN/attr	forward
X/NOUN/conj_<tulip/NOUN/conj_<Y/NOUN/dobj	forward
X/NOUN/conj_<tulip/NOUN/conj_<Y/NOUN/dobj_>elm/NOUN/conj	forward
other/ADJ/amod<_X/NOUN/dobj_<Y/NOUN/appos	reverse
X/NOUN/attr_<with/ADP/prep_<Y/NOUN/pobj	forward
range/NOUN/nmod<_X/NOUN/attr_<with/ADP/prep_<Y/NOUN/pobj	forward
ballistic/ADJ/amod<_X/NOUN/attr_<with/ADP/prep_<Y/NOUN/pobj	forward
X/NOUN/compound>_ferry/NOUN/compound>_service/NOUN/ROOT_<Y/NOUN/compound	forward
X/NOUN/nsubj>_hospital/NOUN/nsubj>_be/VERB/ROOT_<Y/NOUN/attr	forward
X/NOUN/nsubjpass>_fish/NOUN/nsubjpass>_strip/VERB/ROOT_<Y/NOUN/oprd	reverse
X/PROPN/pobj_<Y/NOUN/appos_>name/VERB/acl	forward
launch/VERB/amod<_X/NOUN/conj_<like/ADP/prep_<Y/NOUN/pobj	forward
X/NOUN/compound>_fruit/NOUN/compound>_flavor/NOUN/ROOT_<Y/NOUN/appos	reverse
X/NOUN/dobj_<shrub/NOUN/conj_<as/ADP/prep_<Y/NOUN/pobj	reverse
X/PROPN/appos_<museum/PROPN/conj_<Y/PROPN/conj	reverse
the/DET/det<_X/PROPN/appos_<museum/PROPN/conj_<Y/PROPN/conj	reverse
X/NOUN/pobj_<have/VERB/relcl_<Y/NOUN/dobj	reverse
the/DET/det<_X/NOUN/pobj_<have/VERB/relcl_<Y/NOUN/dobj	reverse
X/NOUN/nsubj_<g./NOUN/appos_<Y/NOUN/appos	reverse
some/DET/det<_X/NOUN/nsubj_<g./NOUN/appos_<Y/NOUN/appos	reverse
X/NOUN/pobj_<as/ADP/prep_<Y/NOUN/pobj_>in/ADP/prep	reverse
an/DET/det<_X/NOUN/pobj_<with/ADP/prep_<Y/NOUN/pobj	reverse
automatic/ADJ/amod<_X/NOUN/pobj_<launcher/NOUN/conj_<Y/NOUN/compound	reverse
X/NOUN/dobj_<Y/NOUN/appos_>with/ADP/prep	reverse
X/NOUN/pobj_<set/NOUN/conj_<Y/NOUN/compound	reverse
X/NOUN/compound>_weapon/NOUN/compound>_type/NOUN/ROOT_<Y/NOUN/appos	reverse
great/ADJ/amod<_X/NOUN/pobj_<Y/NOUN/conj	reverse
wet/ADJ/amod<_X/NOUN/pobj_<of/ADP/prep_<Y/NOUN/pobj	reverse
alpine/NOUN/compound<_X/NOUN/pobj_<of/ADP/prep_<Y/NOUN/pobj	reverse
hardwood/NOUN/compound<_X/NOUN/pobj_<Y/NOUN/conj	reverse
citrus/NOUN/compound<_X/NOUN/conj_<Y/NOUN/conj	reverse
christmas/PROPN/compound<_X/NOUN/pobj_<Y/NOUN/appos	reverse
boutique/NOUN/compound<_X/NOUN/attr_<in/ADP/prep_<Y/NOUN/pobj	forward
X/NOUN/nsubj>_furniture/NOUN/nsubj>_be/VERB/ROOT_<Y/NOUN/attr	reverse
X/NOUN/nsubj>_vehicle/NOUN/nsubj>_carry/VERB/ROOT_<Y/NOUN/dobj	reverse
X/PROPN/dobj_<hall/PROPN/conj_<Y/PROPN/conj	forward
X/NOUN/dobj_<resemble/VERB/relcl_<Y/NOUN/dobj	forward
X/NOUN/nsubj_<for/ADP/prep_<Y/NOUN/pobj	reverse
the/DET/det<_X/NOUN/dobj_<at/ADP/prep_<Y/NOUN/pobj	reverse
X/NOUN/appos_<in/ADP/prep_<Y/NOUN/pobj	forward
several/ADJ/amod<_X/NOUN/pobj_<include/VERB/prep_<Y/NOUN/pobj	reverse
profile/NOUN/compound<_X/NOUN/pobj_<include/VERB/prep_<Y/NOUN/pobj	reverse
standard/ADJ/amod<_X/NOUN/appos_<Y/NOUN/conj	reverse
special/ADJ/amod<_X/NOUN/conj_<Y/NOUN/conj	reverse
X/NOUN/conj_<Y/NOUN/conj_>or/CCONJ/cc	reverse
X/NOUN/attr_<size/NOUN/appos_<of/ADP/prep_<Y/NOUN/pobj	reverse
three/NUM/nummod<_X/NOUN/dobj_<Y/NOUN/conj	reverse
X/PROPN/compound>_pine/PROPN/compound>_co./PROPN/ROOT_<Y/PROPN/compound	forward
X/NOUN/pobj_<attach/VERB/acl_<to/ADP/prep_<Y/NOUN/pobj	forward
X/NOUN/nsubj>_toaster/NOUN/nsubj>_be/VERB/ROOT_<Y/NOUN/attr	forward
main/ADJ/amod<_X/NOUN/dobj_<of/ADP/prep_<Y/NOUN/pobj	reverse
bristlecone/ADJ/compound<_X/NOUN/pobj_<Y/NOUN/conj	forward
X/NOUN/compound>_fish/NOUN/compound>_farm/NOUN/ROOT_<Y/NOUN/appos	reverse
defensive/ADJ/amod<_X/NOUN/pobj_<Y/NOUN/conj	reverse
X/NOUN/nsubj>_battleship/NOUN/nsubj>_be/VERB/ROOT_<Y/NOUN/attr	forward
X/NOUN/pobj_<Y/NOUN/appos_>at/ADP/prep	forward
the/DET/det<_X/NOUN/appos_<Y/PROPN/conj	reverse
X/NOUN/compound>_fruit/NOUN/compound>_orchard/NOUN/ROOT_<Y/NOUN/relcl	reverse
military/PROPN/compound<_X/PROPN/nsubj_<Y/PROPN/conj	reverse
26/NUM/nummod<_X/NOUN/pobj_<include/VERB/prep_<Y/NOUN/pobj	reverse
topiary/ADJ/compound<_X/NOUN/pobj_<include/VERB/prep_<Y/NOUN/pobj	reverse
X/NOUN/nsubj>_frog/NOUN/nsubj>_be/VERB/ROOT_<Y/NOUN/attr	forward
cellular/ADJ/amod<_X/NOUN/pobj_<Y/NOUN/conj	forward
the/DET/det<_X/PROPN/conj_<hall/PROPN/conj_<Y/PROPN/conj	forward
X/NOUN/pobj_<along/ADP/prep_<with/ADP/prep_<Y/NOUN/pobj	forward
X/NOUN/conj_<Y/PROPN/dobj	reverse
X/NOUN/compound>_salmon/NOUN/compound>_Y/NOUN/ROOT	forward
fine/ADJ/amod<_X/NOUN/dobj_<include/VERB/prep_<Y/NOUN/pobj	reverse
certain/ADJ/amod<_X/NOUN/nsubj_<as/ADP/prep_<Y/PROPN/pobj	reverse
military/ADJ/amod<_X/NOUN/pobj_<Y/NOUN/conj	forward
X/PROPN/nsubj>_villa/PROPN/nsubj>_be/VERB/ROOT_<Y/NOUN/attr	forward
X/NOUN/nsubj>_hornet/NOUN/nsubj>_be/VERB/ROOT_<Y/NOUN/attr	forward
X/NOUN/nsubj_<naped/PROPN/appos_<Y/PROPN/appos	reverse
the/DET/det<_X/NOUN/nsubj_<naped/PROPN/appos_<Y/PROPN/appos	reverse
other/ADJ/amod<_X/NOUN/nsubj_<naped/PROPN/appos_<Y/PROPN/appos	reverse
X/NOUN/nmod>_vehicle/NOUN/nmod>_service/NOUN/ROOT_<Y/NOUN/compound	reverse
first/ADJ/amod<_X/NOUN/attr_<Y/NOUN/conj	reverse
X/NOUN/npadvmod>_rocket/NOUN/npadvmod>_throw/VERB/amod>_Y/NOUN/ROOT	reverse
an/DET/det<_X/NOUN/nsubjpass_<Y/NOUN/appos	reverse
X/NOUN/pobj_<like/ADP/prep_<Y/PROPN/pobj	reverse
X/PROPN/compound>_castle/PROPN/compound>_gould/PROPN/ROOT_<Y/PROPN/conj	forward
X/NOUN/pobj_<Y/PROPN/appos_>at/ADP/prep	reverse
X/NOUN/nsubj>_animal/NOUN/nsubj>_represent/VERB/ROOT_<Y/NOUN/dobj	reverse
X/NOUN/pobj_<Y/NOUN/conj_>design/VERB/acl	forward
X/PROPN/appos_<building/PROPN/conj_<Y/PROPN/conj	forward
X/PROPN/conj_<building/PROPN/conj_<Y/PROPN/conj_>of/ADP/prep	reverse
X/PROPN/conj_<Y/PROPN/conj_>of/ADP/prep	reverse
feed/VERB/amod<_X/NOUN/attr_<as/ADP/prep_<Y/NOUN/pobj	reverse
X/NOUN/dobj_<for/ADP/prep_<Y/PROPN/pobj	reverse
the/DET/det<_X/NOUN/dobj_<for/ADP/prep_<Y/PROPN/pobj	reverse
X/NOUN/nsubj>_bowl/NOUN/nsubj>_be/VERB/ROOT_<Y/NOUN/attr	forward
X/NOUN/pobj_<fish/NOUN/conj_<Y/NOUN/conj_>fish/NOUN/conj	forward
X/NOUN/nsubj>_rifle/NOUN/nsubj>_prove/VERB/ROOT_<Y/NOUN/dobj	forward
X/PROPN/compound>_villa/PROPN/compound>_Y/NOUN/ROOT	forward
red/ADJ/amod<_X/NOUN/dobj_<be/VERB/relcl_<Y/NOUN/attr	reverse
twin/ADJ/amod<_X/NOUN/conj_<launcher/NOUN/conj_<Y/NOUN/compound	forward
n-4/PROPN/nmod<_X/NOUN/conj_<launcher/NOUN/conj_<Y/NOUN/compound	forward
X/NOUN/pobj_<22/NUM/appos_<due/ADP/prep_<Y/NOUN/pobj	reverse
propel/VERB/amod<_X/NOUN/pobj_<Y/NOUN/conj	forward
X/NOUN/appos_<on/ADP/prep_<Y/NOUN/pobj	reverse
booster/NOUN/compound<_X/NOUN/nsubj_<Y/NOUN/conj	reverse
X/NOUN/pobj_<vehicle/NOUN/appos_<become/VERB/relcl_<Y/NOUN/attr	reverse
companion/NOUN/compound<_X/NOUN/conj_<as/ADP/prep_<Y/NOUN/pobj	reverse
X/NOUN/dobj_<of/ADP/prep_<Y/NOUN/pobj_>against/ADP/prep	reverse
police/NOUN/compound<_X/NOUN/pobj_<Y/NOUN/conj	forward
the/DET/det<_X/NOUN/dobj_<from/ADP/prep_<Y/NOUN/pobj	reverse
small/ADJ/amod<_X/NOUN/dobj_<Y/NOUN/appos	reverse
X/NOUN/pobj_<take/VERB/relcl_<motor/NOUN/dobj_<Y/NOUN/compound	forward
X/NOUN/conj_<Y/NOUN/conj_>trout/NOUN/conj	reverse
X/NOUN/ccomp_<great/ADJ/conj_<as/ADP/prep_<Y/NOUN/pobj	reverse
the/DET/det<_X/NOUN/dobj_<call/VERB/acl_<Y/NOUN/oprd	reverse
X/NOUN/dobj_<call/VERB/acl_<Y/NOUN/oprd_>of/ADP/prep	reverse
X/NOUN/pobj_<make/VERB/acl_<from/ADP/prep_<Y/NOUN/pobj	reverse
X/NOUN/attr_<adjacent/ADJ/amod_<to/ADP/prep_<Y/NOUN/pobj	reverse
machine/NOUN/compound<_X/NOUN/pobj_<Y/NOUN/conj	forward
migratory/ADJ/amod<_X/NOUN/pobj_<include/VERB/prep_<Y/NOUN/pobj	reverse
fish/NOUN/compound<_X/NOUN/pobj_<include/VERB/prep_<Y/NOUN/pobj	reverse
X/NOUN/ccomp_<Y/NOUN/conj	reverse
-pron-/PRON/nsubj<_X/NOUN/ccomp_<Y/NOUN/conj	reverse
X/NOUN/compound>_fruit/NOUN/compound>_production/NOUN/ROOT_<Y/NOUN/appos	reverse
domestic/ADJ/amod<_X/NOUN/pobj_<Y/NOUN/conj	forward
X/NOUN/nsubj>_rocket/NOUN/nsubj>_power/VERB/ROOT_<Y/NOUN/dobj	reverse
X/NOUN/compound>_television/NOUN/compound>_studio/NOUN/ROOT_<Y/NOUN/appos	forward
X/PROPN/pobj_<Y/PROPN/appos_>of/ADP/prep	reverse
X/NOUN/pobj_<connect/VERB/relcl_<to/ADP/prep_<Y/NOUN/pobj	reverse
X/PROPN/pobj_<Y/NOUN/appos_>one/NUM/conj	forward
X/NOUN/ROOT_<include/VERB/prep_<Y/NOUN/pobj	reverse
endanger/VERB/amod<_X/NOUN/appos_<Y/NOUN/appos	reverse
X/NOUN/oprd_<for/ADP/prep_<Y/NOUN/pobj	forward
the/DET/det<_X/NOUN/pobj_<at/ADP/prep_<Y/NOUN/pobj	forward
X/NOUN/compound>_hotel/NOUN/compound>_Y/NOUN/ROOT_>at/ADP/prep	forward
X/NOUN/pobj_<rum-139/PROPN/appos_<Y/NOUN/dobj	forward
the/DET/det<_X/NOUN/pobj_<rum-139/PROPN/appos_<Y/NOUN/dobj	forward
rim-66/PROPN/nmod<_X/NOUN/pobj_<rum-139/PROPN/appos_<Y/NOUN/dobj	forward
ii/PROPN/compound<_X/NOUN/pobj_<rum-139/PROPN/appos_<Y/NOUN/dobj	forward
surface/NOUN/nmod<_X/NOUN/pobj_<rum-139/PROPN/appos_<Y/NOUN/dobj	forward
whole/ADJ/amod<_X/NOUN/dobj_<Y/NOUN/appos	reverse
certain/ADJ/amod<_X/NOUN/pobj_<as/ADP/prep_<Y/NOUN/pobj	reverse
X/PROPN/nsubj>_acacia/PROPN/nsubj>_be/VERB/ROOT_<Y/NOUN/attr	forward
X/NOUN/pobj_<from/ADP/prep_<Y/PROPN/pobj	reverse
the/DET/det<_X/NOUN/pobj_<from/ADP/prep_<Y/PROPN/pobj	reverse
X/NOUN/appos_<Y/PROPN/appos	reverse
such/ADJ/amod<_X/NOUN/nsubj_<like/ADP/prep_<Y/NOUN/pobj	reverse
fatty/ADJ/amod<_X/NOUN/nsubj_<like/ADP/prep_<Y/NOUN/pobj	reverse
predatory/ADJ/compound<_X/NOUN/nsubj_<like/ADP/prep_<Y/NOUN/pobj	reverse
style/NOUN/compound<_X/NOUN/nsubj_<as/ADP/prep_<Y/NOUN/pobj	reverse
four/NUM/nummod<_X/NOUN/nsubj_<Y/NOUN/appos	reverse
different/ADJ/amod<_X/NOUN/nsubj_<Y/NOUN/appos	reverse
X/NOUN/poss>_castle/NOUN/poss>_force/NOUN/ROOT_<Y/NOUN/compound	forward
512-bed/NUM/nummod<_X/NOUN/dobj_<Y/NOUN/conj	forward
inpatient/ADJ/amod<_X/NOUN/dobj_<Y/NOUN/conj	forward
X/NOUN/dobj_<Y/NOUN/conj_>building/NOUN/conj	forward
X/NOUN/nmod>_rocket/NOUN/nmod>_Y/NOUN/ROOT	reverse
the/DET/det<_X/NOUN/nmod>_rocket/NOUN/nmod>_Y/NOUN/ROOT	reverse
X/NOUN/nsubj>_fish/NOUN/nsubj>_include/VERB/ROOT_<Y/PROPN/dobj	reverse
large/ADJ/amod<_X/NOUN/pobj_<like/ADP/prep_<Y/NOUN/pobj	reverse
assault/NOUN/compound<_X/NOUN/pobj_<Y/NOUN/conj	reverse
X/NOUN/nsubj>_building/NOUN/nsubj>_contain/VERB/ROOT_<Y/NOUN/dobj	reverse
hill/PROPN/compound<_X/PROPN/pobj_<Y/NOUN/appos	forward
X/NOUN/dobj_<become/VERB/relcl_<Y/NOUN/attr	reverse
old/ADJ/amod<_X/PROPN/pobj_<Y/PROPN/conj	forward
X/NOUN/compound>_missile/NOUN/compound>_motor/NOUN/ROOT_<Y/NOUN/compound	forward
X/PROPN/compound>_castle/PROPN/compound>_blackadder/PROPN/ROOT_<Y/NOUN/appos	forward
X/NOUN/nsubj>_fruit/NOUN/nsubj>_be/VERB/ROOT_<Y/NOUN/acomp	reverse
X/NOUN/npadvmod_<Y/NOUN/conj	forward
X/PROPN/nsubj_<Y/PROPN/appos_>or/CCONJ/cc	forward
flame/NOUN/compound<_X/NOUN/attr_<Y/NOUN/conj	reverse
X/PROPN/nsubj>_vehicle/PROPN/nsubj>_be/VERB/ROOT_<Y/NOUN/attr	reverse
symmetrical/ADJ/amod<_X/NOUN/pobj_<Y/NOUN/conj	reverse
redstone/PROPN/compound<_X/NOUN/nsubj_<Y/NOUN/appos	reverse
red/ADJ/amod<_X/NOUN/conj_<Y/NOUN/conj	forward
the/DET/det<_X/NOUN/ccomp_<Y/NOUN/conj	reverse
X/NOUN/ccomp_<Y/NOUN/conj_>in/ADP/prep	reverse
X/NOUN/pobj_<carry/VERB/relcl_<Y/NOUN/dobj	reverse
states/PROPN/compound<_X/NOUN/attr_<Y/NOUN/appos	forward
navy/PROPN/compound<_X/NOUN/attr_<Y/NOUN/appos	forward
X/NOUN/pobj_<as/ADP/prep_<system/NOUN/pobj_<Y/NOUN/compound	reverse
another/DET/det<_X/NOUN/pobj_<Y/NOUN/conj	forward
some/DET/det<_X/NOUN/pobj_<Y/NOUN/appos	reverse
popular/ADJ/amod<_X/NOUN/pobj_<Y/NOUN/appos	reverse
X/NOUN/amod_<Y/NOUN/conj	forward
X/PROPN/compound>_missile/PROPN/compound>_canister/PROPN/compound>_Y/NOUN/ROOT	forward
X/NOUN/poss>_missile/NOUN/poss>_booster/NOUN/ROOT_<Y/NOUN/compound	forward
X/NOUN/nsubj>_animal/NOUN/nsubj>_be/VERB/ROOT_<Y/NOUN/npadvmod	reverse
X/NOUN/dobj_<of/ADP/prep_<Y/NOUN/pobj_>for/ADP/prep	reverse
white/ADJ/amod<_X/NOUN/dobj_<Y/NOUN/conj	forward
the/DET/det<_X/PROPN/attr_<Y/PROPN/conj	forward
X/NOUN/nsubj>_weapon/NOUN/nsubj>_consist/VERB/ROOT_<Y/NOUN/dobj	reverse
specialized/ADJ/amod<_X/NOUN/dobj_<as/ADP/prep_<Y/NOUN/pobj	reverse
power/NOUN/compound<_X/NOUN/attr_<Y/NOUN/conj	forward
mess/VERB/amod<_X/NOUN/conj_<Y/NOUN/conj	forward
X/NOUN/conj_<coach/NOUN/conj_<with/ADP/prep_<Y/NOUN/pobj	reverse
ballistic/ADJ/amod<_X/NOUN/pobj_<Y/NOUN/conj	forward
X/NOUN/compound>_animal/NOUN/compound>_tattoo/NOUN/ROOT_<Y/NOUN/appos	reverse
X/NOUN/attr_<develop/VERB/acl_<for/ADP/prep_<Y/NOUN/pobj	reverse
X/NOUN/nsubj>_washer/NOUN/nsubj>_be/VERB/ROOT_<Y/NOUN/attr	forward
X/NOUN/nsubj>_building/NOUN/nsubj>_house/VERB/ROOT_<Y/NOUN/dobj	reverse
basilica/PROPN/compound<_X/PROPN/appos_<Y/NOUN/conj	forward
enemy/NOUN/nmod<_X/NOUN/pobj_<Y/NOUN/conj	reverse
an/DET/det<_X/NOUN/attr_<as/ADP/prep_<Y/NOUN/pobj	reverse
dakota/PROPN/nmod<_X/NOUN/attr_<Y/NOUN/appos	forward
X/NOUN/attr_<Y/NOUN/appos_>name/VERB/relcl	forward
class/NOUN/nmod<_X/NOUN/attr_<Y/NOUN/appos	forward
the/DET/det<_X/NOUN/dobj_<for/ADP/prep_<Y/NOUN/pobj	reverse
brick/NOUN/compound<_X/NOUN/dobj_<for/ADP/prep_<Y/NOUN/pobj	reverse
X/NOUN/nsubj>_missile/NOUN/nsubj>_Y/NOUN/ROOT	forward
aim-4/DET/nmod<_X/NOUN/nsubj>_missile/NOUN/nsubj>_Y/NOUN/ROOT	forward
falcon/PROPN/compound<_X/NOUN/nsubj>_missile/NOUN/nsubj>_Y/NOUN/ROOT	forward
air/NOUN/nmod<_X/NOUN/nsubj>_missile/NOUN/nsubj>_Y/NOUN/ROOT	forward
first/ADJ/amod<_X/NOUN/nsubjpass_<Y/NOUN/appos	forward
cruise/NOUN/compound<_X/NOUN/nsubjpass_<Y/NOUN/appos	forward
X/NOUN/nsubjpass_<missile/NOUN/appos_<Y/NOUN/conj_>ba/PROPN/appos	forward
ballistic/ADJ/amod<_X/NOUN/appos_<Y/NOUN/conj	forward
X/NOUN/appos_<Y/NOUN/conj_>ba/PROPN/appos	forward
X/NOUN/appos_<Y/NOUN/conj_>of/ADP/prep	forward
X/NOUN/nsubjpass>_fruit/NOUN/nsubjpass>_call/VERB/ROOT_<Y/NOUN/oprd	reverse
small/ADJ/amod<_X/NOUN/conj_<Y/NOUN/conj	forward
X/PROPN/dobj_<Y/NOUN/appos_>with/ADP/prep	forward
modify/VERB/amod<_X/NOUN/pobj_<Y/NOUN/appos	reverse
sound/VERB/compound<_X/NOUN/pobj_<Y/NOUN/appos	reverse
X/NOUN/pobj_<i/PROPN/appos_<Y/NOUN/conj_>redstone/NOUN/appos	reverse
X/NOUN/dobj_<be/VERB/relcl_<Y/NOUN/attr_>and/CCONJ/cc	reverse
large/ADJ/amod<_X/NOUN/attr_<Y/NOUN/appos	reverse
issue/NOUN/compound<_X/NOUN/pobj_<Y/NOUN/appos	reverse
X/PROPN/nsubj>_bomb/PROPN/nsubj>_be/VERB/ROOT_<Y/NOUN/attr	forward
X/NOUN/nsubj_<call/VERB/acl_<Y/PROPN/oprd	reverse
the/DET/det<_X/NOUN/nsubj_<call/VERB/acl_<Y/PROPN/oprd	reverse
X/NOUN/nsubjpass_<Y/NOUN/appos_>or/CCONJ/cc	reverse
one/NUM/nummod<_X/NOUN/pobj_<Y/NOUN/appos	reverse
X/NOUN/pobj_<demolition/NOUN/conj_<of/ADP/prep_<Y/PROPN/pobj	reverse
X/NOUN/nsubjpass>_building/NOUN/nsubjpass>_Y/NOUN/ROOT	reverse
X/PROPN/nsubj>_phone/PROPN/nsubj>_be/VERB/ROOT_<Y/NOUN/attr	forward
X/PROPN/conj_<in/ADP/prep_<Y/PROPN/pobj	reverse
the/DET/det<_X/PROPN/conj_<in/ADP/prep_<Y/PROPN/pobj	reverse
X/NOUN/nsubj>_hospital/NOUN/nsubj>_open/VERB/ROOT_<Y/NOUN/dobj	forward
six/NUM/nummod<_X/NOUN/attr_<Y/NOUN/appos	reverse
the/DET/det<_X/NOUN/pobj_<for/ADP/prep_<Y/NOUN/pobj	reverse
X/NOUN/nsubj>_hospital/NOUN/nsubj>_comprise/VERB/ROOT_<Y/NOUN/dobj	forward
X/NOUN/ROOT_<along/ADP/prep_<with/ADP/prep_<Y/NOUN/pobj	reverse
bank/PROPN/compound<_X/PROPN/conj_<Y/PROPN/conj	reverse
administration/NOUN/compound<_X/NOUN/pobj_<of/ADP/prep_<Y/NOUN/pobj	reverse
X/NOUN/pobj_<include/VERB/prep_<Y/NOUN/pobj_>as/ADP/cc	reverse
either/CCONJ/preconj<_X/PROPN/pobj_<Y/NOUN/conj	reverse
response/PROPN/compound<_X/PROPN/pobj_<Y/NOUN/conj	reverse
X/PROPN/compound>_pine/PROPN/compound>_park/PROPN/ROOT_<Y/PROPN/compound	forward
game/NOUN/compound<_X/NOUN/nsubj>_fish/NOUN/nsubj>_Y/NOUN/ROOT	reverse
diameter/PROPN/compound<_X/PROPN/conj_<Y/PROPN/conj	forward
X/PROPN/conj_<Y/PROPN/conj_>sfw/PROPN/appos	forward
the/DET/det<_X/NOUN/npadvmod_<Y/NOUN/conj	forward
-pron-/ADJ/poss<_X/NOUN/pobj_<include/VERB/prep_<Y/NOUN/pobj	reverse
the/DET/det<_X/NOUN/pobj_<become/VERB/relcl_<Y/NOUN/attr	forward
X/NOUN/dobj_<school/PROPN/conj_<of/ADP/prep_<Y/NOUN/pobj	forward
X/PROPN/pobj_<gardens/PROPN/conj_<Y/PROPN/compound	reverse
the/DET/det<_X/PROPN/pobj_<gardens/PROPN/conj_<Y/PROPN/compound	reverse
coach/PROPN/compound<_X/PROPN/pobj_<gardens/PROPN/conj_<Y/PROPN/compound	reverse
medical/ADJ/amod<_X/NOUN/pobj_<include/VERB/prep_<Y/NOUN/pobj	reverse
command/NOUN/compound<_X/NOUN/pobj_<Y/NOUN/conj	reverse
fleshy/ADJ/amod<_X/NOUN/nsubjpass_<like/ADP/prep_<Y/NOUN/pobj	reverse
X/NOUN/nsubjpass>_fruit/NOUN/nsubjpass>_confuse/VERB/ROOT_<Y/NOUN/npadvmod	reverse
altitude/NOUN/compound<_X/NOUN/nsubjpass_<as/ADP/prep_<Y/NOUN/pobj	reverse
X/PROPN/compound>_pine/PROPN/compound>_flag/PROPN/ROOT_<Y/PROPN/compound	forward
X/NOUN/nsubj_<with/ADP/prep_<Y/NOUN/pobj	forward
the/DET/det<_X/NOUN/nsubj_<with/ADP/prep_<Y/NOUN/pobj	forward
X/PROPN/nsubj>_ferry/PROPN/nsubj>_be/VERB/ROOT_<Y/NOUN/attr	forward
X/NOUN/compound>_conifer/NOUN/compound>_Y/NOUN/ROOT	reverse
X/PROPN/ROOT_<Y/PROPN/conj	reverse
cover/VERB/amod<_X/NOUN/dobj_<as/ADP/prep_<Y/NOUN/pobj	reverse
rtac/PROPN/compound<_X/NOUN/dobj_<as/ADP/prep_<Y/NOUN/pobj	reverse
X/PROPN/pobj_<Y/NOUN/appos_>be/VERB/relcl	forward
X/NOUN/nsubjpass_<next/ADV/advmod_<to/ADP/prep_<Y/NOUN/pobj	reverse
X/NOUN/conj_<design/VERB/acl_<represent/VERB/xcomp_<Y/NOUN/dobj	reverse
X/PROPN/attr_<use/VERB/acl_<as/ADP/prep_<Y/NOUN/pobj	reverse
motorize/VERB/amod<_X/NOUN/dobj_<as/ADP/prep_<Y/NOUN/pobj	reverse
X/PROPN/nsubj>_hotel/PROPN/nsubj>_become/VERB/ROOT_<Y/NOUN/attr	forward
X/NOUN/attr_<know/VERB/acl_<as/ADP/prep_<Y/PROPN/pobj	reverse
X/NOUN/compound>_rabbit/NOUN/compound>_hutch/NOUN/nsubjpass>_Y/NOUN/ROOT	forward
heavy/ADJ/amod<_X/NOUN/pobj_<Y/NOUN/appos	reverse
X/NOUN/pobj_<Y/NOUN/appos_>use/VERB/relcl	reverse
X/NOUN/nmod>_rocket/NOUN/nmod>_industry/NOUN/ROOT_<Y/NOUN/compound	reverse
X/NOUN/attr_<with/ADP/prep_<booster/NOUN/pobj_<Y/NOUN/compound	forward
hoofed/ADJ/amod<_X/NOUN/pobj_<Y/NOUN/appos	reverse
game/NOUN/compound<_X/NOUN/pobj_<Y/NOUN/appos	reverse
X/NOUN/nsubjpass_<with/ADP/prep_<engine/NOUN/pobj_<Y/NOUN/compound	forward
ground/NOUN/compound<_X/NOUN/pobj_<as/ADP/prep_<Y/NOUN/pobj	reverse
X/PROPN/conj_<springs/PROPN/conj_<Y/PROPN/compound	reverse
poplar/PROPN/compound<_X/PROPN/conj_<springs/PROPN/conj_<Y/PROPN/compound	reverse
X/PROPN/npadvmod_<Y/PROPN/conj	forward
X/NOUN/pobj_<include/VERB/prep_<Y/NOUN/pobj_>sturgeon/NOUN/conj	reverse
freshwater/ADJ/amod<_X/NOUN/nsubj_<as/ADP/prep_<Y/NOUN/pobj	reverse
X/NOUN/pobj_<far/ADV/advmod_<from/ADP/prep_<Y/PROPN/pobj	reverse
silk/PROPN/compound<_X/PROPN/conj_<Y/NOUN/conj	forward
X/NOUN/pobj_<include/VERB/prep_<Y/PROPN/pobj_>and/CCONJ/cc	reverse
river/PROPN/compound<_X/PROPN/pobj_<Y/NOUN/appos	forward
X/PROPN/compound>_pine/PROPN/compound>_creek/PROPN/ROOT_<Y/PROPN/compound	forward
crathes/PROPN/compound<_X/PROPN/dobj_<Y/PROPN/conj	forward
X/PROPN/dobj_<Y/PROPN/conj_>castle/PROPN/conj	forward
X/NOUN/pobj_<Y/NOUN/appos_>salmon/NOUN/conj	reverse
X/NOUN/pobj_<trout/NOUN/appos_<Y/NOUN/conj_>and/CCONJ/cc	reverse
X/NOUN/pobj_<trout/NOUN/appos_<Y/NOUN/conj_>char/NOUN/conj	reverse
X/NOUN/attr_<resemble/VERB/relcl_<Y/NOUN/dobj	reverse
rainbow/NOUN/compound<_X/NOUN/pobj_<Y/NOUN/appos	forward
X/PROPN/attr_<Y/PROPN/appos	reverse
both/DET/preconj<_X/NOUN/pobj_<Y/NOUN/conj	reverse
X/NOUN/nsubjpass>_carp/NOUN/nsubjpass>_consider/VERB/ROOT_<Y/NOUN/oprd	forward
X/PROPN/compound>_castle/PROPN/compound>_martin/PROPN/ROOT_<Y/PROPN/conj	forward
historic/ADJ/amod<_X/NOUN/attr_<Y/NOUN/conj	forward
X/NOUN/dobj_<eagle/NOUN/appos_<Y/NOUN/appos	reverse
four/NUM/nummod<_X/NOUN/dobj_<eagle/NOUN/appos_<Y/NOUN/appos	reverse
X/PROPN/compound>_building/PROPN/compound>_complex/PROPN/ROOT_<Y/PROPN/conj	reverse
the/DET/det<_X/PROPN/conj_<Y/NOUN/appos	forward
both/DET/det<_X/NOUN/pobj_<Y/NOUN/conj	forward
natural/ADJ/amod<_X/NOUN/dobj_<include/VERB/prep_<Y/NOUN/pobj	reverse
X/NOUN/dobj_<include/VERB/prep_<Y/NOUN/pobj_>trout/NOUN/conj	reverse
X/PROPN/ROOT_<at/ADP/prep_<Y/PROPN/pobj	reverse
X/NOUN/nsubj>_car/NOUN/nsubj>_overtake/VERB/ROOT_<Y/NOUN/dobj	forward
X/NOUN/nsubj>_fruit/NOUN/nsubj>_become/VERB/ROOT_<Y/NOUN/attr	reverse
X/NOUN/dobj_<at/ADP/prep_<Y/PROPN/pobj	reverse
elsick/PROPN/compound<_X/PROPN/conj_<Y/PROPN/conj	reverse
mastic/NOUN/amod<_X/NOUN/pobj_<Y/NOUN/conj	reverse
carob/NOUN/amod<_X/NOUN/pobj_<Y/NOUN/conj	reverse
madrona/NOUN/amod<_X/NOUN/conj_<Y/NOUN/conj	reverse
olive/NOUN/amod<_X/NOUN/conj_<Y/NOUN/conj	reverse
various/ADJ/amod<_X/NOUN/dobj_<as/ADP/prep_<Y/NOUN/pobj	reverse
X/NOUN/pobj_<from/ADP/prep_<base/NOUN/pobj_<Y/NOUN/compound	reverse
X/PROPN/conj_<park/PROPN/conj_<gardens/PROPN/conj_<Y/PROPN/conj	reverse
X/NOUN/nsubjpass>_clothing/NOUN/nsubjpass>_take/VERB/ROOT_<Y/NOUN/advcl	reverse
X/NOUN/nsubj>_weapon/NOUN/nsubj>_be/VERB/ROOT_<Y/NOUN/nsubj	reverse
X/NOUN/attr_<between/ADP/prep_<Y/NOUN/pobj	reverse
an/DET/det<_X/NOUN/attr_<between/ADP/prep_<Y/NOUN/pobj	reverse
intermediate/ADJ/amod<_X/NOUN/attr_<between/ADP/prep_<Y/NOUN/pobj	reverse
X/NOUN/attr_<than/ADP/prep_<Y/NOUN/pobj	reverse
century/NOUN/compound<_X/NOUN/pobj_<Y/NOUN/conj	forward
X/NOUN/dobj_<of/ADP/prep_<palace/NOUN/pobj_<Y/PROPN/conj	reverse
assaultcube/PROPN/poss<_X/NOUN/nsubj_<Y/NOUN/appos	reverse
X/PROPN/nsubj_<in/ADP/prep_<Y/PROPN/pobj	reverse
X/NOUN/pobj_<as/ADP/prep_<Y/PROPN/pobj_>salmons/PROPN/conj	reverse
dry/VERB/amod<_X/NOUN/pobj_<as/ADP/prep_<Y/NOUN/pobj	reverse
X/NOUN/pobj_<load/NOUN/appos_<of/ADP/prep_<Y/NOUN/pobj	reverse
the/DET/det<_X/PROPN/nsubjpass_<Y/PROPN/conj	reverse
X/PROPN/dobj_<hotel/PROPN/conj_<Y/PROPN/conj	reverse
the/DET/det<_X/PROPN/dobj_<hotel/PROPN/conj_<Y/PROPN/conj	reverse
X/PROPN/conj_<hotel/PROPN/conj_<Y/PROPN/conj	forward
X/NOUN/nsubjpass>_fruit/NOUN/nsubjpass>_Y/NOUN/ROOT	reverse
city/NOUN/poss<_X/NOUN/nsubjpass>_fruit/NOUN/nsubjpass>_Y/NOUN/ROOT	reverse
main/ADJ/amod<_X/NOUN/nsubjpass>_fruit/NOUN/nsubjpass>_Y/NOUN/ROOT	reverse
X/NOUN/nsubj>_arm/NOUN/nsubj>_be/VERB/ROOT_<Y/NOUN/attr	reverse
fresh/ADJ/amod<_X/NOUN/pobj_<Y/NOUN/conj	reverse
X/NOUN/nsubj>_seabird/NOUN/nsubj>_include/VERB/ROOT_<Y/PROPN/dobj	reverse
bamburgh/PROPN/compound<_X/PROPN/conj_<Y/NOUN/conj	forward
berkeley/PROPN/compound<_X/PROPN/conj_<Y/NOUN/conj	forward
dover/PROPN/compound<_X/PROPN/conj_<Y/NOUN/conj	forward
X/NOUN/nsubj_<on/ADP/prep_<Y/NOUN/pobj	forward
the/DET/det<_X/NOUN/nsubj_<on/ADP/prep_<Y/NOUN/pobj	forward
X/NOUN/nsubjpass_<be/VERB/relcl_<Y/NOUN/attr	reverse
X/PROPN/nsubj>_hospital/PROPN/nsubj>_spread/VERB/ROOT_<Y/NOUN/advcl	forward
X/NOUN/nsubj>_hospital/NOUN/nsubj>_outgrow/VERB/ROOT_<Y/NOUN/dobj	forward
X/NOUN/pobj_<name/VERB/acl_<Y/NOUN/oprd	reverse
large/ADJ/amod<_X/NOUN/dobj_<as/ADP/prep_<Y/NOUN/pobj	reverse
X/NOUN/conj_<Y/PROPN/conj_>in/ADP/prep	reverse
redstone/PROPN/compound<_X/NOUN/dobj_<Y/NOUN/conj	reverse
X/NOUN/dobj_<Y/NOUN/conj_>vehicle/NOUN/conj	reverse
X/NOUN/nsubj>_robin/NOUN/nsubj>_cardìgliu/NOUN/ROOT_<Y/NOUN/appos	forward
28/NUM/nummod<_X/NOUN/nsubj_<include/VERB/prep_<Y/NOUN/pobj	reverse
private/ADJ/amod<_X/NOUN/dobj_<Y/NOUN/conj	reverse
display/NOUN/compound<_X/NOUN/pobj_<as/ADP/prep_<Y/NOUN/pobj	reverse
buddhist/ADJ/amod<_X/NOUN/pobj_<Y/NOUN/appos	reverse
monastic/ADJ/amod<_X/NOUN/pobj_<Y/NOUN/appos	reverse
X/NOUN/pobj_<Y/NOUN/appos_>tricivara/NOUN/conj	reverse
X/NOUN/pobj_<steelhead/PROPN/appos_<Y/NOUN/appos	reverse
-pron-/ADJ/poss<_X/NOUN/pobj_<steelhead/PROPN/appos_<Y/NOUN/appos	reverse
abundant/ADJ/amod<_X/NOUN/pobj_<steelhead/PROPN/appos_<Y/NOUN/appos	reverse
anadromous/ADJ/amod<_X/NOUN/pobj_<steelhead/PROPN/appos_<Y/NOUN/appos	reverse
X/NOUN/appos_<mansion/PROPN/conj_<park/NOUN/conj_<Y/NOUN/appos	reverse
X/NOUN/attr_<locate/VERB/acl_<in/ADP/prep_<Y/NOUN/pobj	forward
X/PROPN/nsubj>_lion/PROPN/nsubj>_be/VERB/ROOT_<Y/NOUN/attr	forward
tall/ADJ/amod<_X/NOUN/attr_<Y/NOUN/conj	forward
X/NOUN/nmod>_tree/NOUN/nmod>_specie/NOUN/ROOT_<Y/NOUN/appos	reverse
X/NOUN/pobj_<call/VERB/relcl_<Y/NOUN/oprd	forward
X/NOUN/nsubj>_equipment/NOUN/nsubj>_include/VERB/ROOT_<Y/NOUN/dobj	reverse
X/NOUN/attr_<Y/NOUN/conj_>of/ADP/prep	reverse
many/ADJ/amod<_X/NOUN/pobj_<Y/NOUN/appos	reverse
domestic/ADJ/amod<_X/NOUN/pobj_<Y/NOUN/appos	reverse
X/PROPN/nsubj>_hospital/PROPN/nsubj>_rename/VERB/ROOT_<Y/PROPN/dobj	forward
any/DET/det<_X/NOUN/pobj_<include/VERB/prep_<Y/NOUN/pobj	reverse
in/ADP/prep<_X/NOUN/ROOT_<for/ADP/prep_<Y/NOUN/pobj	reverse
angler/VERB/nsubj<_X/NOUN/ROOT_<for/ADP/prep_<Y/NOUN/pobj	reverse
top/ADJ/amod<_X/NOUN/pobj_<as/ADP/prep_<Y/NOUN/pobj	reverse
predator/NOUN/compound<_X/NOUN/pobj_<as/ADP/prep_<Y/NOUN/pobj	reverse
game/NOUN/compound<_X/NOUN/dobj_<include/VERB/prep_<Y/NOUN/pobj	reverse
X/NOUN/compound>_tree/NOUN/compound>_Y/NOUN/ROOT	reverse
stone/PROPN/compound<_X/PROPN/attr_<Y/NOUN/appos	forward
turkish/ADJ/amod<_X/NOUN/appos_<Y/NOUN/conj	forward
aleppo/PROPN/compound<_X/PROPN/conj_<Y/NOUN/conj	forward
blue/PROPN/compound<_X/PROPN/conj_<Y/NOUN/conj	forward
eastern/PROPN/compound<_X/PROPN/conj_<Y/NOUN/conj	forward
white/PROPN/compound<_X/PROPN/conj_<Y/NOUN/conj	forward
maritime/PROPN/compound<_X/PROPN/conj_<Y/NOUN/conj	forward
X/NOUN/pobj_<include/VERB/prep_<Y/NOUN/pobj_>carp/NOUN/conj	reverse
X/NOUN/attr_<mass/NOUN/conj_<of/ADP/prep_<Y/NOUN/pobj	forward
aperture/PROPN/compound<_X/PROPN/dobj_<Y/NOUN/appos	reverse
science/PROPN/compound<_X/PROPN/dobj_<Y/NOUN/appos	reverse
handheld/PROPN/compound<_X/PROPN/dobj_<Y/NOUN/appos	reverse
portal/PROPN/compound<_X/PROPN/dobj_<Y/NOUN/appos	reverse
X/NOUN/compound>_animal/NOUN/compound>_character/NOUN/ROOT_<Y/NOUN/appos	reverse
garrison/NOUN/compound<_X/NOUN/appos_<Y/NOUN/appos	forward
-pron-/ADJ/poss<_X/NOUN/pobj_<include/VERB/relcl_<Y/NOUN/dobj	reverse
X/NOUN/pobj_<ignite/VERB/relcl_<Y/NOUN/nsubjpass	forward
guide/VERB/amod<_X/NOUN/pobj_<ignite/VERB/relcl_<Y/NOUN/nsubjpass	forward
X/NOUN/pobj_<over/ADP/prep_<Y/NOUN/pobj	forward
X/NOUN/conj_<set/NOUN/conj_<Y/NOUN/compound	reverse
X/PROPN/dobj_<Y/NOUN/conj_>and/CCONJ/cc	forward
ury/PROPN/compound<_X/PROPN/attr_<Y/PROPN/conj	reverse
migratory/ADJ/amod<_X/NOUN/nsubj_<as/ADP/prep_<Y/NOUN/pobj	reverse
X/PROPN/compound>_castle/PROPN/compound>_house/PROPN/ROOT_<Y/PROPN/conj	forward
X/NOUN/pobj_<on/ADP/prep_<site/NOUN/pobj_<Y/PROPN/compound	reverse
X/NOUN/pobj_<derivative/NOUN/conj_<Y/NOUN/compound	reverse
develop/VERB/amod<_X/NOUN/pobj_<derivative/NOUN/conj_<Y/NOUN/compound	reverse
X/NOUN/attr_<near/ADP/prep_<Y/PROPN/pobj	reverse
X/NOUN/nsubj>_fish/NOUN/nsubj>_include/VERB/ROOT_<Y/NOUN/xcomp	reverse
administration/NOUN/compound<_X/NOUN/attr_<Y/NOUN/conj	reverse
X/NOUN/nsubj_<include/VERB/prep_<Y/PROPN/pobj	reverse
heavy/ADJ/amod<_X/NOUN/compound>_weapon/NOUN/compound>_Y/NOUN/ROOT	reverse
X/NOUN/nsubj>_house/NOUN/nsubj>_replace/VERB/ROOT_<Y/PROPN/dobj	reverse
one/NUM/nummod<_X/NOUN/dobj_<Y/NOUN/conj	reverse
ruin/VERB/amod<_X/NOUN/pobj_<Y/NOUN/conj	forward
sucker/NOUN/compound<_X/NOUN/conj_<Y/NOUN/conj	reverse
powerful/ADJ/amod<_X/NOUN/pobj_<Y/NOUN/appos	reverse
elkhart/PROPN/compound<_X/PROPN/conj_<Y/NOUN/conj	forward
general/PROPN/compound<_X/PROPN/conj_<Y/NOUN/conj	forward
hercules/PROPN/compound<_X/PROPN/pobj_<Y/NOUN/conj	forward
rechargable/ADJ/amod<_X/NOUN/pobj_<Y/NOUN/appos	reverse
communication/NOUN/compound<_X/NOUN/pobj_<Y/NOUN/appos	reverse
several/ADJ/amod<_X/NOUN/nsubj_<as/ADP/prep_<Y/NOUN/pobj	reverse
X/PROPN/compound>_pine/PROPN/compound>_station/PROPN/ROOT_<Y/PROPN/compound	forward
capital/NOUN/compound<_X/NOUN/dobj_<Y/NOUN/appos	reverse
X/NOUN/dobj_<cruiser/NOUN/appos_<Y/NOUN/conj_>or/CCONJ/cc	reverse
X/NOUN/dobj_<cruiser/NOUN/appos_<Y/NOUN/conj_>aircraft/NOUN/conj	reverse
wasserfall/PROPN/compound<_X/NOUN/pobj_<Y/NOUN/appos	reverse
period/NOUN/compound<_X/NOUN/dobj_<include/VERB/prep_<Y/NOUN/pobj	reverse
pershing/PROPN/nmod<_X/NOUN/pobj_<Y/NOUN/conj	forward
range/NOUN/nmod<_X/NOUN/pobj_<Y/NOUN/conj	forward
any/DET/det<_X/NOUN/pobj_<like/ADP/prep_<Y/NOUN/pobj	reverse
enable/VERB/amod<_X/NOUN/pobj_<like/ADP/prep_<Y/NOUN/pobj	reverse
X/NOUN/compound>_animal/NOUN/compound>_bone/NOUN/ROOT_<Y/NOUN/appos	reverse
X/PROPN/conj_<hospital/PROPN/conj_<Y/PROPN/conj	forward
the/DET/det<_X/PROPN/conj_<hospital/PROPN/conj_<Y/PROPN/conj	forward
original/ADJ/amod<_X/PROPN/conj_<hospital/PROPN/conj_<Y/PROPN/conj	forward
armored/ADJ/amod<_X/NOUN/conj_<Y/NOUN/conj	forward
X/PROPN/nsubj>_building/PROPN/nsubj>_be/VERB/ROOT_<Y/NOUN/attr	reverse
X/NOUN/compound>_animal/NOUN/compound>_theme/NOUN/ROOT_<Y/NOUN/appos	reverse
X/PROPN/compound>_poplar/PROPN/compound>_school/PROPN/ROOT_<Y/PROPN/compound	forward
cold/ADJ/amod<_X/NOUN/pobj_<include/VERB/prep_<Y/NOUN/pobj	reverse
X/NOUN/pobj_<Y/NOUN/prep	reverse
-pron-/ADJ/poss<_X/NOUN/nsubj_<Y/NOUN/appos	reverse
all/ADJ/predet<_X/NOUN/pobj_<Y/NOUN/appos	reverse
lebel/PROPN/compound<_X/NOUN/pobj_<Y/NOUN/appos	reverse
caliber/NOUN/compound<_X/NOUN/pobj_<Y/NOUN/appos	reverse
X/NOUN/pobj_<in/ADP/prep_<entertainment/NOUN/pobj_<Y/NOUN/compound	forward
X/NOUN/ROOT_<be/VERB/relcl_<Y/NOUN/attr	forward
muchalls/PROPN/compound<_X/PROPN/conj_<Y/PROPN/conj	forward
game/NOUN/compound<_X/NOUN/nsubjpass_<as/ADP/prep_<Y/NOUN/pobj	reverse
X/PROPN/attr_<Y/PROPN/conj_>castle/PROPN/conj	reverse
X/PROPN/compound>_pine/PROPN/compound>_gulch/PROPN/ROOT_<Y/PROPN/compound	forward
twizell/PROPN/compound<_X/PROPN/pobj_<Y/PROPN/conj	forward
X/PROPN/pobj_<Y/PROPN/conj_>seghill/PROPN/conj	forward
X/PROPN/compound>_pine/PROPN/compound>_academy/PROPN/ROOT_<Y/PROPN/compound	forward
-pron-/ADJ/poss<_X/NOUN/pobj_<in/ADP/prep_<Y/PROPN/pobj	forward
own/ADJ/amod<_X/NOUN/pobj_<in/ADP/prep_<Y/PROPN/pobj	forward
several/ADJ/amod<_X/NOUN/pobj_<include/VERB/prep_<Y/PROPN/pobj	reverse
endanger/VERB/amod<_X/NOUN/pobj_<include/VERB/prep_<Y/PROPN/pobj	reverse
X/NOUN/pobj_<include/VERB/prep_<Y/PROPN/pobj_>diehli/NOUN/appos	reverse
X/NOUN/pobj_<subspecie/NOUN/appos_<of/ADP/prep_<Y/PROPN/pobj	reverse
sport/NOUN/compound<_X/NOUN/appos_<as/ADP/prep_<Y/NOUN/pobj	reverse
burrowing/PROPN/compound<_X/PROPN/nsubj_<Y/NOUN/appos	forward
different/ADJ/amod<_X/NOUN/pobj_<Y/NOUN/prep	reverse
X/NOUN/dep_<Y/NOUN/appos	reverse
X/NOUN/conj_<property/NOUN/conj_<include/VERB/relcl_<Y/NOUN/dobj	forward
edible/ADJ/amod<_X/NOUN/nsubjpass_<as/ADP/prep_<Y/NOUN/pobj	reverse
X/NOUN/poss>_missile/NOUN/poss>_engine/NOUN/ROOT_<Y/NOUN/compound	forward
X/NOUN/nsubj>_animal/NOUN/nsubj>_be/VERB/ROOT_<Y/NOUN/acomp	reverse
commercial/ADJ/amod<_X/NOUN/pobj_<Y/NOUN/conj	reverse
X/NOUN/nsubj>_artifact/NOUN/nsubj>_include/VERB/ROOT_<Y/NOUN/dobj	reverse
X/NOUN/attr_<select/VERB/relcl_<with/ADP/prep_<Y/NOUN/pobj	reverse
primary/ADJ/amod<_X/NOUN/pobj_<Y/NOUN/appos	reverse
X/PROPN/attr_<be/VERB/relcl_<Y/NOUN/attr	forward
one/NUM/nummod<_X/NOUN/dobj_<Y/NOUN/appos	forward
wild/ADJ/amod<_X/NOUN/pobj_<as/ADP/prep_<Y/NOUN/pobj	reverse
netherley/PROPN/compound<_X/PROPN/conj_<Y/PROPN/conj	reverse
deciduous/ADJ/amod<_X/NOUN/pobj_<Y/NOUN/appos	reverse
petrol/NOUN/compound<_X/NOUN/pobj_<like/ADP/prep_<Y/NOUN/pobj	reverse
stage/NOUN/compound<_X/NOUN/attr_<with/ADP/prep_<Y/NOUN/pobj	reverse
iron/NOUN/compound<_X/NOUN/dobj_<as/ADP/prep_<Y/NOUN/pobj	reverse
X/NOUN/compound>_ambulance/NOUN/compound>_Y/NOUN/ROOT	forward
new/ADJ/amod<_X/NOUN/nsubj_<of/ADP/prep_<Y/PROPN/pobj	reverse
X/NOUN/conj_<variety/NOUN/conj_<of/ADP/prep_<Y/NOUN/pobj	forward
X/PROPN/compound>_hospital/PROPN/compound>_Y/NOUN/ROOT	forward
salmonid/ADJ/amod<_X/NOUN/pobj_<like/ADP/prep_<Y/NOUN/pobj	reverse
X/NOUN/pobj_<feature/VERB/acl_<Y/NOUN/dobj	reverse
bionic/ADJ/amod<_X/NOUN/pobj_<feature/VERB/acl_<Y/NOUN/dobj	reverse
X/PROPN/compound>_pine/PROPN/compound>_high/PROPN/ROOT_<Y/PROPN/compound	forward
